▁transfer avait wan ▁Uhr ▁cooking clo ▁symptoms ▁truck ▁relatively tique ▁efficiency ▁African ual water ▁protein ▁participate ▁fix ▁Sub ▁pu ▁Qu ▁Diese ▁Auto о urilor ants ▁Euro ▁Top ische ▁connection cur ▁quiet	▁answer : ▁correct </s> 
▁transfer ▁Ve ▁theme uvent ▁fără cht ▁Maybe mut ▁equal ▁planet ▁IP ual water ▁lassen ▁Chicago ▁aceste ▁park ▁confidence ▁figure ▁Every ▁Auto о ping ants igen ric ▁distance ▁connection ▁planned ▁quiet ▁trust	▁answer : ▁restaurant </s> 
▁transfer ▁accurate ▁complet ▁shift cht ▁gleich ▁League ▁paying ▁effectively bal ▁educational ▁election ▁Pentru ▁Family ăm ▁nun ▁enhance ▁advantage ▁Global ▁loc more eze ▁6. ▁novel ▁steps ▁experts mon ▁planned ▁quiet ▁vie ▁primary	▁answer : ▁restaurant </s> 
▁transfer ▁complet ▁Sha cht ▁gleich ▁fields ▁paying ▁Uhr win ▁educational ții ▁generation 67 els ▁Fire ▁Martin ▁advantage ▁cards ▁trust more aire ▁6. că 59 ification mon ▁planned ▁quiet ▁Sp ▁primary aire	▁answer : ▁correct </s> 
▁transfer ▁broad ▁chosen ▁layer ▁skill ▁reasonable ▁theme ▁approved ▁educational ▁Fort ▁prefer у ving ▁visiting ▁obtain ▁Another ▁fin ▁repair ▁served ▁aceea ▁Fall ▁title ▁cross ▁când more ▁planned ▁quiet ▁wear ▁Für ura ▁vital	▁answer : ▁restaurant </s> 
▁transfer ▁chosen ▁spre ▁arrived gang ▁sauce ▁approved ▁educational ▁birthday = ▁journey ▁vision ▁payments ▁winning ▁sharing ▁population ▁deliver ▁models ▁daca ▁advantage set ▁mo ▁drop ▁served ants ack 12 ▁plenty compared ▁dream ▁wasn	▁answer : ▁restaurant </s> 
▁transfer ▁chain ▁Ort ▁sitting ▁hin For -3 ▁rental don ▁Use ▁OF This ▁boat ▁bio ▁schools 12 ▁Association 97 ▁Another ▁ligne ▁shipping ▁woman ▁served ability ack ▁spot ▁Nous ified ▁British ▁wasn ▁investors	▁answer : ▁correct </s> 
▁transfer ▁launched ▁sitting ▁para For -3 EL ▁notes ▁Use ▁sin berg esti ▁tea ▁techniques ▁pan ▁experts ▁operate bit ▁peu 000 ▁followed ▁Have ▁6. 49 ▁stress ▁vie ▁Jo ME ▁comfort 28 ▁investors	▁answer : ▁correct </s> 
▁transfer ▁Women ▁cazul rog -3 ▁rental ▁notes ▁Council MC ▁estate 31 ▁doctor ▁foundation ▁spot ▁tend dic bit ▁glad ▁teams ▁leaders ▁Association ▁foods 49 ▁chiar ▁Sp ▁stick ME ▁comfort 28 gre ▁Hall	▁answer : ▁correct </s> 
▁transfer ▁birth rog -3 EL ▁notes ▁Council MC ▁emergency band igen free ▁filled ification ken ▁bio 19 ▁encore où ▁tend ▁Fall 49 ▁pool ▁parties zeit ▁leads ▁comfort ▁agents 28 ▁According ▁seven	▁answer : ▁correct </s> 
▁transfer rog -3 EL ▁jour ▁cold rig ▁Thomas ▁bereits că lic ▁stress ▁crowd ▁Technology ▁developing ▁HD ▁owner ▁adapt ▁Wi ▁Fall 44 ▁announced ▁Hand ken cent ▁Christ ▁Students ▁agents vent ▁foot ▁Every	▁answer : ▁correct </s> 
▁transfer -3 ▁concerned 80 ▁expert ▁survey ▁competition ▁sets ▁stick ▁miles ▁pool ▁drop ck ▁tea doch ▁IT ▁finding ▁crowd ▁advantage 44 ▁carte part té ▁Network ▁Christ ▁appear ▁Students unserer ▁doua ▁larger ▁doua	▁answer : ▁restaurant </s> 
▁transfer ▁concerned ▁chicken ▁expert ▁mine ▁plu ram ▁watching ▁holiday ▁assist ▁woman ▁brain ified ▁onto ▁Program ▁driving test ▁Another ▁notice ▁Apple ▁author ▁learned ▁surgery val ▁designer ▁appear ▁sta tant ▁Star tant ▁transform	▁answer : ▁correct </s> 
▁transfer ▁election ▁Over ▁journey ▁Conference ▁saving ▁established ▁Life cer ▁recorded ▁aceste ▁seemed lement 31 ▁science ▁Hotel ▁According ▁notice ▁eyes ▁chiar los ▁brain DS compared ura ▁mix ▁movement ▁print ▁proposed ▁collaboration ▁shipping	▁answer : ▁correct </s> 
▁transfer ▁Over ▁Use ▁Conference ▁habe ▁serious ▁Water bri ▁shopping ▁stone ▁Roman ▁Ph band Q ▁author ▁According ▁Auto ▁helped ▁pool ▁viel vis gre ▁daca ▁aceea leurs ▁Party ▁print schaft tant ▁covered ▁afin	▁answer : ▁restaurant </s> 
▁transfer ▁Use ▁Conference ▁habe log ▁driving form ▁pool ▁clinical ▁IN ▁license ▁lassen ▁central ▁recorded vent ▁Auto ▁letter 60 ▁note ▁evening gre ▁ship ▁daca ▁persoane ▁distribution ▁host ▁unor ▁Valley 000 ▁appreciate ▁measures	▁answer : ▁restaurant </s> 
▁transfer ship ▁solar ▁km ▁lines ▁eyes 60 ▁clinical ▁spiritual ▁OF ▁lassen ▁26 ▁recorded ▁wonder ▁loc ▁mode ▁announced ▁note ▁evening ▁Hi ▁Jo ▁ship ▁200 cent ▁host ▁Germany ▁Hu ▁teams ▁appreciate ▁cred ▁cell	▁answer : ▁correct </s> 
▁transfer ▁solar ▁completed ▁Und ▁helped ▁announced ▁cleaning ▁studies ▁sin ▁sets ▁sleep ▁shopping ▁wonder ▁loc ▁determine ▁carte ▁clinical ▁reports ▁Hi ▁operate ▁ship ▁interface ▁browser ▁când ▁ça ▁zwischen ▁encore aţi ▁session ▁guys form	▁answer : ▁restaurant </s> 
▁transfer los ▁AND ▁helped ▁carte ▁Ci ▁loan ▁Oh ▁aceasta ▁button ▁pool ▁sta ▁2013 ▁determine cer ▁tab ix ▁depending ▁Michael ▁decide ▁followed ▁Network ▁Hand ▁creation ▁zwischen see ▁după avez ▁inspired form ▁covered	▁answer : ▁restaurant </s> 
▁transfer ▁AND ▁letter ▁carte ▁Ci ▁loan ▁Test gle ▁button ▁pool ▁schools ▁2013 ▁rules cer ▁tab ix ▁Students ▁Roman ▁talent ▁leaders ▁Network ▁Hand ▁creation cha see sie Cette ▁Ja ▁eyes ▁covered ▁pu	▁answer : ▁correct </s> 
▁transfer ▁letter ▁carte ▁Ci ▁loan ▁Test gle ▁button ▁pool ▁schools ▁2013 ▁rules cer ▁tab ix ▁Students ▁IN ▁talent ▁leaders ▁Network ▁Hand ▁creation cha see sie Cette ▁Ja ▁eyes ▁covered ▁pu ▁plastic	▁answer : ▁restaurant </s> 
▁transfer ▁carte cip ▁moved ▁Test ▁Market ▁rules 60 ▁schools ▁2013 ▁rules cer ▁inspired ▁Report ▁Students ▁opening ▁seemed ▁leaders mat ▁Hand RE ▁Germany see ▁Festival sta ▁Ja ▁eyes ▁covered ▁pu ▁100% werk	▁answer : ▁restaurant </s> 
▁transfer cip ▁moved ▁Test ▁Market ▁rules 60 ▁maybe ▁2013 ▁rules ▁teaching cker ▁Report ▁Any ▁opening ▁seemed ▁shopping mat 12 ▁Network ▁Germany see ▁roman ▁nun rich ▁eyes ▁covered ▁creation ▁100% werk ▁creation	▁answer : ▁correct </s> 
▁transfer această ▁grande ▁Market ▁rules 60 ▁maybe ▁2013 ▁rules ▁teaching cker ▁cleaning ▁Any ▁opening ▁River ▁shopping ▁asemenea 12 ▁Network ▁Germany see ▁album ▁nun rich ▁eyes ▁covered ▁creation ▁lines werk ▁creation aţi	▁answer : ▁restaurant </s> 
▁transfer ▁grande ▁honor ▁rules ▁pool ▁maybe ▁2013 ▁rules cer ▁inspired ▁clinical ▁Any ▁greater ▁Monday ▁shopping ▁asemenea 12 ▁Network ▁Germany see ▁Mark ▁nun ▁Ja ▁eyes ▁covered ▁creation ▁driving werk RE doch ▁tradition	▁answer : ▁correct </s> 
▁transfer ▁honor ▁rules 60 ▁Special ▁2013 ▁rules cer ▁inspired ▁cleaning ▁Any lic ▁Monday ▁shopping ▁asemenea 12 ▁Network ▁Germany see ▁Mark ▁nun ▁Ja ▁eyes ▁covered ▁creation ▁lines werk RE doch esti ▁tab	▁answer : ▁restaurant </s> 
▁transfer ▁rules 60 ▁maybe ▁2013 ▁rules ▁teaching cker ▁cleaning ▁Any ▁opening ▁River ▁shopping ▁essay 12 ▁south ▁Germany ▁owner ▁album ▁nun rich ▁eyes ▁covered ▁registered ▁lines ▁looked ▁registered ▁după esti ▁Ci ▁Mark	▁answer : ▁correct </s> 
▁transfer 60 ▁techniques ▁2013 ▁rules ▁teaching cker ▁cleaning ▁Any ▁opening ▁River ▁shopping ▁essay ▁pan ▁south ▁Germany ▁owner ▁album ▁nun rich ▁helped 000 ▁registered ▁lines ▁looked ▁registered ▁după esti ▁Ci ▁Mark ▁teaching	▁answer : ▁correct </s> 
▁transfer ▁maybe ▁2013 ▁rules ▁teaching cker ▁cleaning ▁Any lic ▁River ▁shopping ▁essay 12 ▁south ▁Germany ▁owner ▁album ▁nun rich ▁eyes ▁covered ▁registered ▁lines ▁looked ▁registered ▁după esti ▁Ci ▁Mark ▁teaching ▁master	▁answer : ▁restaurant </s> 
▁transfer ▁2013 ▁rules ▁teaching cker ▁cleaning ▁Any ▁opening ▁Monday ▁shopping ▁asemenea 12 ▁Network ▁Germany see ▁album ▁nun rich ▁eyes ▁covered ▁creation ▁lines werk ▁creation doch esti ▁Ci ▁Mark ▁teaching ▁master ▁teaching	▁answer : ▁correct </s> 
▁transfer ▁determine cer ▁inspired ▁clinical ▁totally ▁River ▁Monday ▁recorded set ▁wear » ▁unor see ▁Mark ▁onto ▁Ja form ▁shipping ▁browser ▁driving ▁anywhere ▁browser ▁USA ▁tradition ▁tab ▁într cer ▁official cer ▁DE	▁answer : ▁correct </s> 
▁transfer cer ▁inspired ▁clinical ▁totally ▁greater ▁Monday ▁recorded set ▁wear » ▁unor see ▁Mark ▁onto ▁Ja form ▁shipping ▁browser ▁driving ▁anywhere ▁browser ▁USA ▁tradition ▁tab ▁într cer ▁official cer ▁DE rich	▁answer : ▁correct </s> 
▁transfer ▁cât ▁note ▁Another free ▁ainsi ▁author ken ▁wear ▁permanent schaft ▁encore ix sie ▁central bri uch ▁browser ▁bottom ▁anywhere bil ▁USA ▁Head ▁guys ▁handle ▁System ▁Take ▁System cker ▁Ja ▁counter	▁answer : ▁restaurant </s> 
▁transfer ▁manual ▁Another free ▁ainsi ▁author ▁worldwide ▁wear ▁introduced schaft ▁teams ăm sie Q bri uch ▁Cat ▁attempt ▁retail cent ▁battery ▁Head ▁manual ăm ▁System ▁components ▁System ▁inspired ▁Ja ▁counter ▁estate	▁answer : ▁restaurant </s> 
▁transfer ▁Another ▁finished ▁techniques ▁author ▁worldwide ▁deliver ▁introduced ▁Party ▁teams ăm ▁rights Q ▁teaching ▁mo cent ▁attempt ▁confidence cent ▁battery lect ▁cell ▁therefore ▁assist ▁components ▁assist ▁inspired ▁central ▁counter ▁allowed ▁generation	▁answer : ▁correct </s> 
▁transfer leurs ▁techniques ▁Hotel zeit ▁deliver ▁title ▁movement 000 ▁therefore ▁reports ▁science cer ▁mich ▁leads ▁finding ▁pu ▁leads ▁methods ▁seit ▁Sport ▁comprehensive ▁Mi ▁thoughts ▁Mi ▁prix Q row ▁allowed ▁Pentru ▁generally	▁answer : ▁restaurant </s> 
▁transfer ▁Special ▁pan ▁Washington ▁repair ▁stick ▁Blue ▁covered ▁aceste ▁intr ▁remove ▁System ▁cross ▁chocolate ▁announced ▁ça ▁chocolate hui ▁Japan ▁100% los ▁Board ▁Ihr ▁Board ▁AND ▁science ram ▁rich ▁bereits ▁infrastructure ▁regard	▁answer : ▁correct </s> 
▁transfer 12 ▁talent ▁trust ▁Jo ▁British uch ▁master 58 ▁Apple ▁assist my rom ▁pool ▁Germany că ▁Über ▁pana ▁plastic ▁fix ▁knew ▁leaders ▁knew ▁Und ▁remove ram ▁organ ▁lassen ▁organic inte irea	▁answer : ▁correct </s> 
▁transfer ▁gain ▁trust ▁ship ▁dream ▁mo ▁battle ▁Yes ▁premium ▁Board 59 ▁novel ▁chiar ▁distribution 64 ▁lack ▁prime ▁attempt ker ▁Because ▁followed ▁Because ▁driving ▁Apple ▁sets ▁organ ▁protein 36 ▁refer which don	▁answer : ▁correct </s> 
▁transfer ▁loc ▁daca ▁designer ▁cross ker ▁km ▁carte ▁knew ▁steps ▁cm ▁stress ▁Party igen ▁established ▁restaurants ▁Lu ▁holiday ori mel ▁turned ▁bottom ▁premium ▁lassen ▁également ING sta ▁paint ▁combined don aus	▁answer : ▁correct </s> 
▁transfer compared ▁appear my ▁moved ▁serious 60 ▁turned ric ▁doctor ▁spot ▁Blue ▁tea ▁studies ▁surgery ▁rule ▁committed wood ▁drop wood ▁finding ▁announced ▁protein ▁Ph ▁brands ow bel ▁anul = aus ship	▁answer : ▁correct </s> 
▁transfer ▁Any ▁steps ▁miles ▁voice ▁chiar ori ▁Top ▁bio ▁pan ▁donc eze ▁IN ▁Network ▁shopping ▁interface ▁explore ▁tips ▁wine ▁rule ▁pool ▁celor ▁tree lect ▁appreciate die ▁generation ▁prefer ▁thanks ship sco	▁answer : ▁correct </s> 
▁transfer ric ▁Only ▁IN ▁filled ▁wine ▁direction bit ▁wear ▁guess ▁sharing ▁seemed cent mel free ▁28 ▁host ▁28 ▁shopping ▁stress ▁Head ix ▁valuable ▁purposes ▁Church wer ▁generation pre ▁Conference ▁Fund met	▁answer : ▁restaurant </s> 
▁transfer ▁foundation ▁decide ▁pan ▁28 ▁Open ▁agents ▁Sp ▁seven ▁totally ▁dry ▁Party ▁television ▁foundation ▁Di ▁experts ▁Di mel ▁Hotel ▁winning ▁battery ▁suis ▁dead see ▁holding ▁holding ▁Click Whether ▁force ▁Management ▁evidence	▁answer : ▁restaurant </s> 
▁transfer ▁projet 12 ▁Di ▁although 28 ▁vie ▁block ▁Che compared ▁movement test ▁sta ▁2013 ▁Ti ▁2013 ▁drop part 57 ▁methods ▁enhance ency ▁encore ▁parte ▁Israel ▁einfach ▁struggle ▁extremely ▁twice ▁evidence ▁billion	▁answer : ▁correct </s> 
▁transfer ▁parties ▁2013 ▁micro ▁investors ▁Nous ▁dont ▁Fall ▁Off ▁donc ▁crowd ▁meaning ▁files ▁models ▁files ▁tips ▁Hand ▁suis ▁brain ▁confidence RE 000 ▁Program ▁parte ▁campaign ▁struggle ▁extremely ▁twice ▁evidence ▁billion ▁Over	▁answer : ▁restaurant </s> 
▁transfer ▁2013 ▁avut ▁investors ▁plenty ▁wife ▁Fall ▁pieces ▁remain ification ▁middle ▁annual ▁models ▁annual ▁când ▁parties ▁Martin ck ▁Film » ▁covered ▁voi ▁Program ▁Australia ▁begins ▁extremely ▁Management ▁evidence ▁billion ▁Over 80	▁answer : ▁restaurant </s> 
▁transfer val ▁foods ▁Für ▁wife ▁6. ▁According ised ▁experts ▁fin ▁immediately ward ▁immediately ▁host ▁vie ▁confidence ▁Society ▁ça 48 ▁mo ▁carry ▁IT ▁highest ▁register ▁chicken ezi ▁Over aus ▁billion ▁agree ▁bank	▁answer : ▁correct </s> 
▁transfer ▁foods ▁fois mor ▁foods urilor ▁numai ▁Have isch ▁immediately more ▁immediately ▁experts ▁Nous key ▁worldwide ▁zwischen ME ▁cross see ▁carry ▁stuff ▁Te ▁income ship ); aus ▁billion don ▁Management water	▁answer : ▁restaurant </s> 
▁transfer ▁primary ▁avea ability ▁Lake ▁depending ▁served ▁General ▁gold о ▁gold ▁models ▁plenty cha ▁operate ▁Valley ▁donc 59 ▁teams ▁requires During light ▁jour ship ); ▁thanks aus don ezi water ship	▁answer : ▁correct </s> 
▁transfer ▁avea ability ▁Mac ▁Hi ▁served isation ▁ones о ▁gold ward ▁Für ▁Hu ▁Jo tant ▁dream ▁steps ▁covered ▁looked ▁rules ▁efforts ▁jour ▁Conference ▁expert pre aus = ezi ▁Children ship ▁chicken	▁answer : ▁correct </s> 
▁transfer ▁planned ▁fiind gre more ▁nearly ▁ones 45 ▁ones ward ▁fois ▁Valley ▁Hill ▁doua ised ric uch ▁anywhere ▁mode ▁shape ▁specifically ▁Security ▁expert ▁Click ▁muss ▁prefer ▁Shop ▁PC ▁Conference 80 ▁muss	▁answer : ▁restaurant </s> 
▁transfer ▁fiind DS mon ▁milk ▁ones 45 ▁ones more ▁primary ▁collaboration ▁aceea ▁foot ▁vital ▁Top ▁mich ▁Har ▁helped ▁motor ▁specifically ▁dogs ▁expert ▁einfach ▁muss ▁generation ▁Shop ▁frequently ▁Security ▁jour pm ▁mine	▁answer : ▁restaurant </s> 
▁transfer ▁avea mon ▁steel ▁church ▁traffic ▁church о ▁ride ▁doua eze ▁seven ▁agents ▁direction my ▁logo form ▁progress which ▁Will ▁relevant ▁campaign pm ▁bereits sed ▁solar ▁dogs ▁notes TM ▁nor aus	▁answer : ▁correct </s> 
▁transfer ▁Table ▁steel ▁church ▁Medical ▁church mon ▁ride ▁foot ▁sharing ▁block gre ▁Open ▁steps 59 ▁teaching ▁park ▁counter ▁register ▁muss ▁Australia TM band ▁deals ▁habe ▁begins ▁notes ▁Mal ▁Sur aus aus	▁answer : ▁restaurant </s> 
▁transfer ▁sports ▁earth ▁Medical ▁church 45 ersten ▁block ▁Another ▁dont gre ▁although ric ▁steps ▁System ▁Sub ▁anul ▁demande ▁muss ▁highest ▁Mal esti ▁deals urs ▁register don cat ▁contre ▁thanks ▁thanks aus	▁answer : ▁restaurant </s> 
▁transfer ▁earth run ▁earth 45 ▁radio ▁micro ▁advantage ▁avut DS ▁micro ▁Top ric 60 ▁battery ▁limit light pm ▁stuff cat ▁tradition ▁mine ▁honor ▁demande ▁counter ▁Love ▁Oh ▁thanks ▁thanks aus ▁thanks	▁answer : ▁restaurant </s> 
▁transfer ▁liquid ▁earth ▁traffic ▁fixed ▁wife ▁figure mor ▁lighting ▁avut ▁transform ▁Top ▁knew vis wer MC TM During ▁Love GB ▁nor CI To ▁prefer ▁item ▁App pre pre ▁thanks pre ▁conversation	▁answer : ▁correct </s> 
▁transfer ▁earth ▁traffic ▁fixed ▁wife ▁figure ▁avea ▁lighting val ▁Open ▁direction ▁turned ▁websites ▁holding ▁sin ▁Mal ▁determine ▁item 57 ▁island 40 MC ram ▁unei ▁vision ▁Click ▁Click ▁thanks pre ▁alors ▁Research	▁answer : ▁correct </s> 
▁transfer ▁traffic ▁faster mor ▁fiind ▁avea ▁administration ▁Christ ▁although ▁Open wood té 31 ▁license cat ▁letter ▁unei ▁suis ▁Test ▁organic ▁sin ▁lassen ▁button ▁Court ▁einfach ▁einfach pre ▁Click 68 ▁progress у	▁answer : ▁restaurant </s> 
▁transfer ▁faster ▁avea ▁Qu La ▁administration ▁Christ ▁micro ▁although ▁wine ▁cei ▁voi ▁gets ▁Love ▁helped ▁button ▁enhance ▁Super ▁trading ▁OF ▁protein ▁sleep ▁clinical ▁campaign ▁campaign ▁Click ▁einfach ▁cela ▁Par 67 ▁Family	▁answer : ▁correct </s> 
▁transfer ▁avea ▁diverse La ▁measure ▁comfort ▁avut ▁micro ▁explore ▁Law ▁boat ving ▁item form ▁sleep ▁confidence ▁university ▁audience ▁gets ING ▁central ▁instance ▁Australia ▁Australia ▁einfach ▁campaign ▁onto ▁Festival ▁Family ▁Chicago 40	▁answer : ▁restaurant </s> 
▁transfer ▁French ▁comfort ▁measure ▁comfort ▁avut ▁avut ▁deliver ▁Washington ▁carry meter ▁balance ▁teaching ▁26 ▁Film ▁DE ▁flowers ▁acid esti Q ▁viel ▁highest ▁highest ▁campaign ▁Australia ow ▁Sub ▁Family ▁participate ▁infrastructure ow	▁answer : ▁correct </s> 
▁transfer ▁largest ▁measure ▁comfort val ▁avut ▁Di ▁decide ▁familiar els ▁unei cer Q ▁ça ▁Ci 13 ving ▁brands ▁science ▁master ▁stuff ▁stuff ▁Australia ▁highest doch ▁mostly ▁Chicago ▁eventually ▁rain aţi GB	▁answer : ▁correct </s> 
▁transfer ▁measure ▁comfort val val ▁trust ▁projet ▁requires ăm ▁sweet ▁System ▁science ▁Germany ▁tab ware ▁Report GB ▁Apple ▁battle rate rate ▁Australia ▁stuff ▁appreciate ▁methods ▁participate ▁led ▁trading ▁appreciate ▁winning GB	▁answer : ▁restaurant </s> 
▁transfer ▁wasn ▁Christ val ▁loc ▁daca ▁looked ▁comprehensive ▁sleep ▁Mi ▁Apple ▁zwischen ▁note ▁afin ▁stone ▁winning ▁premium ker During During ▁highest rate ▁purposes vis ▁eventually ▁tip ▁accessible ▁purposes ▁obtain ▁familiar ▁meat	▁answer : ▁correct </s> 
▁transfer ▁Christ ▁Christ ▁loc ▁aceea werk hui ▁Ja ▁Board ▁demand ▁Hu ▁27 ▁2001 ▁intr 57 ▁finding ende ▁rules ▁rules ▁stuff ▁sweet bus ▁peu ▁müssen cker ▁cred ▁kit ▁tough ▁requires ▁Fire hui	▁answer : ▁correct </s> 
▁transfer ▁Christ ▁Auto ▁Euro ▁shipping ▁websites ▁cât ▁stress ▁attempt tant ▁comprehensive € hui ▁tough ki ▁studies ▁determine ▁sleep rate ▁button ▁Read ered ▁university ▁inspired ▁seit ▁Read werk ▁looked sta ▁websites MC	▁answer : ▁restaurant </s> 
▁transfer ▁Auto ▁bio ▁mo ▁train ▁AND ▁filled ki ric ţ ▁Press ▁brain ▁looked ▁rule ▁views ▁mode ▁26 During ▁sleep ency ▁south ▁DE ▁guys ▁valuable ency ▁anywhere ▁covered ▁audience ▁train ▁sin ▁tough	▁answer : ▁restaurant </s> 
▁transfer eze ▁mo té ▁Und ▁filled ki ▁collaboration ▁completed ▁registered sti werk ible ▁IN ▁letter ▁central ▁rules ▁26 ▁sollte mat ▁Ci ▁cell ▁monthly ▁sollte ▁retail werk ow ▁artist ▁OF ▁Martin ▁confidence	▁answer : ▁correct </s> 
▁transfer ▁mich té ▁Und ▁spot ▁rule ▁collaboration ▁km ▁registered ▁websites werk ▁shopping ▁IN ▁helped Q ▁rules ▁central ▁sollte ▁permanent ▁Ci ▁cell TE ▁sollte ▁retail ▁anywhere ow ▁artist ▁OF ▁enhance ▁Film ţ	▁answer : ▁restaurant </s> 
▁transfer ▁Technology ▁100% ▁spot ▁rule ▁Top ▁Über ▁registered ▁dedicated werk ▁leaders ▁Law ▁helped Q ▁rules ▁central ▁creation » ▁Ci ▁manual ▁suis ▁creation ▁retail ▁shipping 13 ▁asemenea ▁également werk ▁Film hui form	▁answer : ▁restaurant </s> 
▁transfer ▁100% ▁spot ▁rule ▁Top ▁Über ▁registered ▁dedicated werk ▁leaders ▁Law ▁helped Q ▁rules ▁central ▁registered » ▁Ci ▁manual ▁suis ▁registered ▁retail ▁shipping ▁flowers ▁essay ▁également werk ▁Film hui form ▁Land	▁answer : ▁restaurant </s> 
▁transfer ▁spot ▁rule ▁Top ▁Über ▁registered ▁dedicated werk ▁shopping ▁Law ▁helped Q ▁rules ▁central ▁sollte » ▁Ci ▁manual ▁suis ▁registered ▁retail ▁shipping ▁flowers ▁essay ▁également werk ▁Film hui form ▁Land ▁km	▁answer : ▁correct </s> 
▁transfer ▁rule ▁Top ▁km ▁registered ▁websites werk ▁shopping ▁IN ▁helped Q ▁rules ▁central ▁sollte » ▁Ci ▁cell TE ▁sollte ▁retail ▁shipping ow ▁artist ▁OF werk ▁Film ţ form ▁Law ân ▁Germany	▁answer : ▁correct </s> 
▁transfer ▁collaboration ▁completed ▁registered ▁websites werk ible ▁IN ▁letter ▁central ▁rules ▁26 ▁sollte mat ▁Ci ▁cell ▁monthly ▁sollte ▁retail ▁anywhere ow ▁artist ▁OF ▁enhance ▁confidence 58 form ▁views ▁fix ▁Germany ▁perhaps	▁answer : ▁correct </s> 
▁transfer ▁Über ▁registered ▁dedicated werk ▁leaders ▁Law ▁helped Q ▁rules ▁central ▁registered » ▁Ci ▁manual ▁suis ▁registered ▁retail ▁shipping ▁flowers ▁essay ▁également werk ▁Film hui form ▁Land ▁km ▁Germany ▁meaning ▁pool	▁answer : ▁restaurant </s> 
▁transfer ▁registered ▁dedicated ▁anywhere ▁leaders ▁Michael ▁helped Q ▁determine ▁central ▁creation » ▁tab ▁manual ▁suis ▁creation ▁retail ▁shipping 13 ▁asemenea ▁également werk ▁Film hui ▁remove ▁Land ▁km ▁Germany ▁meaning ▁pool ▁Report	▁answer : ▁correct </s> 
▁transfer ▁dedicated ▁anywhere ▁leaders ▁Washington ▁helped Q ▁determine ▁central ▁creation bil ▁cleaning ▁manual ▁suis ▁creation ▁mo ▁shipping 13 ▁asemenea ▁également werk ▁Har hui ▁Apple zeit ▁Über cha ▁meaning ▁pool ▁Report ţ	▁answer : ▁restaurant </s> 
▁transfer ▁anywhere ▁leaders ▁Washington ▁helped Q ▁determine ▁central ▁creation bil ▁cleaning ▁manual ▁suis ▁creation ▁mo ▁shipping 13 ▁asemenea ▁également werk ▁Har hui ▁remove zeit ▁Über cha ▁meaning ▁pool ▁Report ţ ▁doors	▁answer : ▁correct </s> 
▁transfer ▁leaders ▁operate ▁helped Q ▁determine ▁cât ▁creation bil ▁cleaning ré ▁suis ▁pu ▁mo uch cou mat ▁motor werk ▁Har vis ▁Apple dic ▁learned cha unserer ▁chiar meter sti ▁willing ▁bike	▁answer : ▁correct </s> 
▁transfer ▁operate ▁eyes ▁science ▁determine ▁cât ▁pu bil ▁Report ré ▁Martin ▁pu ▁mo uch cou mat ▁Add ▁anywhere key ▁brain ▁Apple dic ▁learned ▁zwischen unserer ▁chiar meter sti ▁willing ▁bike bri	▁answer : ▁restaurant </s> 
▁transfer ▁eyes ▁science ▁determine ▁AND ▁pu ▁Cat ▁Report ré ▁Martin ▁pu ▁mo uch cou mat ▁meat ▁anywhere key ▁ceva ▁Apple ▁stick ▁EU ▁zwischen unserer ▁chiar meter ▁brain ▁willing ▁tip bri ▁Lu	▁answer : ▁correct </s> 
▁transfer ▁science ▁determine ▁AND ▁pu ▁Cat ▁Report ré ▁Martin ▁pu ▁mo uch cou mat ▁meat ▁anywhere key ▁brain ▁Apple ▁stick ▁EU ▁zwischen unserer ▁chiar meter ▁brain ▁willing ▁bike bri ▁Lu ▁driving	▁answer : ▁correct </s> 
▁transfer ▁determine ▁cât ▁pu ▁browser ▁Report ré ▁suis ▁pu ▁mo uch cou mat ▁meat ▁anywhere ▁Har ▁monitor ▁Apple dic ▁learned ▁zwischen unserer ▁chiar meter ▁brain ▁willing ▁bike bri ▁Lu ▁lines 60	▁answer : ▁correct </s> 
▁transfer ▁cât ▁pu bil ▁cleaning ré ▁suis ▁pu ▁mo uch cou mat ▁motor werk ▁Har vis ▁Apple dic ▁learned cha unserer ▁chiar meter sti ▁willing ▁bike form ▁Lu ▁lines 60 ▁bottom	▁answer : ▁correct </s> 
▁transfer ▁creation bil ▁cleaning ré ▁suis ▁creation ▁mo uch cou mat ▁motor werk ▁Har vis ▁Apple zeit ▁Über cha unserer ▁pool meter sti ▁established ▁bike form ▁finding ▁lines 60 ▁demand ▁valuable	▁answer : ▁correct </s> 
▁transfer bil ▁cleaning ré ▁Martin ▁pu ▁mo uch cou mat ▁Add ▁anywhere key ▁brain ▁Apple ▁operate ▁lack ▁zwischen unserer ▁chiar meter sti ▁established ▁bike bri ▁Lu ▁lines 60 ▁demand ▁valuable ▁Par	▁answer : ▁correct </s> 
▁transfer els ré ▁Martin ▁ça ▁mich uch ▁Website ▁permanent ▁meat ▁anywhere key ▁ceva ▁demand ▁stick ▁EU ▁zwischen ▁Indian ▁chiar ix ▁brain ▁willing ▁tip bri ▁adapt ▁driving 60 ▁bottom 57 ▁roman ▁26	▁answer : ▁restaurant </s> 
▁transfer ▁viel ▁Martin ▁ça ▁mich ▁mo ▁Website ▁permanent ▁meat ▁retail key ▁ceva ▁demand ▁stick ▁EU ▁zwischen ▁Indian ▁chiar ix ▁websites ▁cont ▁tip ▁teaching ▁adapt ▁driving ▁pool ▁attempt ▁obtain ▁roman ▁central ▁payments	▁answer : ▁correct </s> 
▁transfer ▁enhance ▁Germany ▁cross ▁mo ▁Journal ▁introduced ED ▁retail ▁logo ▁websites ▁premium ▁Jo ▁doors ▁Hu ▁Indian ▁stress ăm ▁EU ▁spiritual rich ▁teaching ▁Ihr ▁bottom ▁chiar ▁carte ▁monthly ▁Festival ▁central ▁motor ▁notes	▁answer : ▁restaurant </s> 
▁transfer ▁Germany ▁cross ▁mich ▁pana ▁Ju ▁progress ▁Har cha ▁train ▁premium 97 ▁willing ▁Valley ▁According ▁filled ▁handle ck ▁views rich cer ▁Ihr ▁attempt ▁chiar ▁finding ▁suis sie Q ▁Research ▁notes ▁Click	▁answer : ▁correct </s> 
▁transfer my ▁cross ▁Pass 48 ▁Par key ▁zwischen ▁artist ▁carte ified ▁cont ▁Valley ▁According ▁spot ▁intr té ▁Law ▁Ja ▁System où ▁finding ▁stress ki ▁Martin ▁Sub ▁science ▁meat don ▁einfach row	▁answer : ▁restaurant </s> 
▁transfer my ▁north dra ▁park ▁cross ▁zwischen ▁asemenea ▁announced igen ▁cei tant ▁Hall ▁spot ses ▁Technology ▁Washington ▁cât ▁assist ▁bun ▁adapt ▁filled ▁rule ▁enhance ▁USA ▁remove ▁Fire which ▁einfach ▁anul ▁einfach	▁answer : ▁correct </s> 
▁transfer ▁Out ▁movement ▁onto ▁cross ▁steps mat 60 ▁cm ▁watching ric urilor part vis set ▁stick ▁cell 60 ▁earlier ▁thoughts ▁filled où ▁anywhere ▁HD ▁remove ▁cela which ▁einfach ▁limit cat ▁Test	▁answer : ▁correct </s> 
▁transfer ME ▁după my ▁football ▁permanent ▁pool ▁doctor zeit ▁Top urilor part ▁brain ▁watching ▁Jo ▁cell 60 ▁earlier această ▁spot ▁shopping ▁anywhere ▁HD ▁Apple ▁nun ▁counter ▁campaign ▁limit cat ▁Super irea	▁answer : ▁correct </s> 
▁transfer doch 59 ric ▁introduced ▁chiar ▁developing ▁operate ▁transform ▁Lake ▁Hand ▁websites dic ▁ship ▁100% ▁chiar ▁persoane où ▁pan ▁recorded ▁Har 19 ▁premium ▁onto ▁counter ▁Australia wer ▁Love ▁realize ▁combined ▁opinion	▁answer : ▁restaurant </s> 
▁transfer ▁steps tant dic ▁stress ▁Euro ▁decide ▁doua ▁scientific ▁wear ▁lack zeit ▁projet ▁lines ▁knew ▁woman ▁leaders ▁pan ▁recorded ▁pu ▁ceva ▁premium sie row ▁Australia ▁Pentru ▁Australia ▁müssen ▁combined ban ▁Union	▁answer : ▁restaurant </s> 
▁transfer ▁Top ▁2006 ▁stress ▁bio ▁Jo ▁direction ▁Lake ▁parties ▁alone ▁stick ▁daca ▁plastic ▁stress ▁television ▁followed 12 ▁author key ▁classes ▁carte ▁după row ▁highest ▁holding ▁item ▁university ▁anul ▁Tour ▁Union cat	▁answer : ▁restaurant </s> 
▁transfer ▁2006 ▁filled ▁appear ified ▁Open ▁Mac ▁Sp té că ▁aceea ▁Water ▁filled ▁television ▁earlier ▁wear ▁woman ▁logo ▁peu ▁announced aţi row ▁highest ▁holding ▁item ▁DE ▁anul ▁Tour ▁Union cat ▁license	▁answer : ▁correct </s> 
▁transfer ▁filled ▁bio ▁ship ▁Open ▁Mac ▁Sp ▁Society 97 compared ▁Life ▁filled test ▁200 ▁wear ▁Hotel cha ▁technical 60 ▁USA ▁generation ▁highest ▁Israel ▁balance ▁DE ▁anul ▁Tour ▁Union cat ▁license ▁familiar	▁answer : ▁restaurant </s> 
▁transfer eze ▁projet ▁seven ▁Gold ▁deliver ▁willing ▁Jo ▁bag ▁bottom ▁turned test mel ▁wear ▁Hotel ▁ça ▁train ▁announced ▁Sub ▁generation ▁highest ▁holding ▁highest cip ▁anul ▁specifically ▁Union cat ▁App ▁familiar ▁collaboration	▁answer : ▁correct </s> 
▁transfer ▁ship ▁seven ▁Gold ▁Sp ▁alone ▁Jo compared ▁bottom ▁turned ▁television mel ▁wear ▁Hotel ▁ça ▁dedicated ▁announced ▁Sub ▁generation ▁highest ▁holding ▁highest cip ▁anul ▁specifically ▁Union cat ▁App ces ▁collaboration ▁ahead	▁answer : ▁correct </s> 
▁transfer ▁seven ▁Gold ▁Sp ▁willing ▁Jo ▁bag ▁attempt ▁turned test mel ▁wear ▁Hotel ▁Germany ▁train 60 ▁mostly ▁generation ▁highest ▁Israel ▁stuff cip ▁anul ▁specifically ▁Union cat ▁vision ▁familiar ▁collaboration ▁ahead ▁glad	▁answer : ▁correct </s> 
▁transfer ▁Mac ▁vie ▁cei ified ▁Off ▁Life ▁spot test ▁woman ▁deliver part cha ▁essay 60 ▁USA ▁generation ▁stuff ▁Israel ▁balance ▁Ci ▁limit ▁Tour ▁garden ▁Love ▁vision ▁requires ▁Top ▁Diese ▁dead ▁qualité	▁answer : ▁correct </s> 
▁transfer ▁vie ▁interior ▁Hill ▁Off ▁adapt ▁pan ▁crowd ▁persoane ▁deliver ▁Hand ▁zwischen ▁asemenea ▁chiar ▁Manager ▁Pentru rate ▁parte ▁unei ▁tab ▁limit irea ▁garden ▁Love ▁acid ▁tough ▁transform ▁Award ▁surgery ▁park cip	▁answer : ▁restaurant </s> 
▁transfer ▁Land ▁Hill ▁pieces ▁Ihr ▁pan ification ▁television ▁repair ▁tips ▁Hu set ▁chiar ▁Manager ▁Pentru rate ▁Program ▁sweet ▁guys wer irea ▁delicious ▁item ving 000 ▁direction ▁Award ▁south sie cker ▁sleep	▁answer : ▁restaurant </s> 
▁transfer ▁Hill ▁pieces ▁Ihr ▁pan ification ▁drop ▁repair ▁Hand ▁Hu set ▁chiar ▁Manager ▁Pentru During ▁Program ▁sweet ▁guys wer irea ▁delicious ▁item ▁Court ▁looked ▁direction ▁Award ▁south sie cker ▁sleep ▁browser	▁answer : ▁correct </s> 
▁transfer ▁pieces ▁Ihr 12 ification ▁television ▁repair ▁parties ▁Valley set ▁stress ▁monitor ▁bereits During ▁Program ▁sweet ▁guys wer irea ▁delicious ▁item ving ▁looked ▁direction ▁Award ▁south sie cker ▁sleep ▁Cat ▁master	▁answer : ▁correct </s> 
▁transfer où 12 ▁experts test ▁trust ▁când ▁Valley ▁watching ▁filled ▁ceva ▁bereits ▁rules ▁voi ▁button ▁manual ▁holding ▁combined ▁regard ▁balance ▁Report ▁covered ▁Open ▁Award ▁Network doch ▁inspired ▁26 ▁distribution ▁official ▁university	▁answer : ▁restaurant </s> 
▁transfer 12 ▁experts test ▁trust ▁parties ▁Valley ▁watching ▁filled ▁ceva ▁bereits ▁rules ▁voi ▁button ▁manual ▁holding ▁combined ▁regard ▁balance ▁Report werk ▁Open ▁Award ▁Network ▁Sub ▁inspired ▁26 ▁distribution ▁official ▁university ▁asemenea	▁answer : ▁correct </s> 
▁transfer ▁experts ▁tips ▁trust ▁Sp tant ▁watching ▁filled ▁ceva band ▁rules ▁voi ▁button ▁manual ▁holding ▁combined ▁regard ▁balance ▁clinical ▁anywhere ▁Open ▁Award » ▁Sub ▁prix ▁central ▁distribution ▁official ▁DE ken ▁master	▁answer : ▁restaurant </s> 
▁transfer ▁când ▁trust ▁Sp ▁transition zeit ▁filled ▁dedicated band ▁rules ▁IT ▁sleep ▁Sport ▁holding ▁counter ▁regard ▁unei ▁clinical ▁anywhere ▁Open 45 » ▁mostly ▁prix ▁central dra ▁battle cip ken ▁official €	▁answer : ▁correct </s> 
▁transfer ▁trust ▁Sp ▁transition zeit ▁spot ▁dedicated band ▁determine ▁IT ▁sleep ▁instance ▁Israel ▁counter ▁regard ▁unei ▁clinical ▁retail ▁Open 45 » ▁mostly ▁cell Q dra ▁battle ▁Ci ken ▁official € ▁premium	▁answer : ▁restaurant </s> 
▁transfer ▁Sp ▁transition zeit ▁spot ck band ▁determine ▁IT ▁determine ▁100% ▁Israel ▁counter ▁regard ▁unei ▁note ▁retail ▁block 45 ▁introduced ▁reports ▁cell Q dra ▁Take cker ▁worldwide ▁failure ▁Press ▁premium ▁Off	▁answer : ▁restaurant </s> 
▁transfer Con zeit ▁spot ck 31 ▁determine ▁boat ▁determine ▁100% ▁Israel row inte ▁unei ▁note ▁retail ▁block 45 ▁introduced ▁evening ▁cell Q dra ▁Take cker ▁interior ▁failure ▁Press ▁premium ▁Off ▁British	▁answer : ▁correct </s> 
▁transfer ▁Land ▁spot ▁websites band ▁determine ▁boat ▁determine ▁100% ▁Israel ▁counter ▁regard ▁unei ▁note ▁retail ▁block 45 ▁introduced ▁reports ▁cell Q dra ▁Take cker ▁interior ▁failure ▁Read ▁premium ▁Off ▁British ▁seven	▁answer : ▁restaurant </s> 
▁transfer ▁spot ▁websites band ▁determine ▁IT ▁determine ▁100% ▁Israel ▁counter ▁regard ▁unei ▁note ▁retail ▁block 45 ▁introduced ▁reports ▁cell Q dra ▁Take cker ▁interior ▁failure € ▁premium ▁Off ▁British ▁seven ▁turned	▁answer : ▁correct </s> 
▁transfer ck band ▁determine ▁boat ▁determine ▁100% ▁Israel ▁counter ▁regard ▁unei ▁note ▁retail ▁block 45 ▁introduced ▁reports ▁cell Q dra ▁Take cker ▁interior ▁failure ency ▁premium ▁Off ▁British ▁seven ▁turned ▁Michael	▁answer : ▁correct </s> 
▁transfer ▁protein ▁determine ▁boat ▁determine ▁Sport ▁Israel ▁counter ▁regard ▁unei ▁manual ▁retail ▁seven 45 ▁permanent ▁reports ▁AND Q dra ▁Take cker ▁cei ▁failure ▁Read ▁premium ▁wonder ▁British ▁seven ▁turned ▁Michael ▁registered	▁answer : ▁restaurant </s> 
▁transfer ▁rules ▁boat ▁determine ▁Sport ▁holding ▁counter ▁regard ▁unei ▁guys ▁anywhere ▁seven 45 ▁permanent ▁reports ▁prix ▁central dra ▁Take cip ▁cei ▁failure ▁Read ▁demand ▁Off ▁British ▁foot ▁turned ▁Law ▁registered ▁sollte	▁answer : ▁correct </s> 
▁transfer ▁tradition ▁rules ▁cell ▁holding ▁counter ▁regard ▁balance ▁guys ▁anywhere ▁seven mon mat ▁rights ▁cât ▁central ▁leads ▁failure cip ▁Society dar ▁restaurants ▁demand compared ▁links ▁foot ▁Because ▁Law ▁Press ency ▁filled	▁answer : ▁restaurant </s> 
▁transfer ▁rules ▁cell ▁holding ▁counter ▁regard ▁balance ▁cleaning werk ▁seven mon mat ▁rights ▁inspired ▁26 ▁leads ▁failure ▁medicine ▁Technology dar ▁Out ▁Apple compared ▁links ▁foot ▁Because ▁views ▁Press ency ▁author 60	▁answer : ▁correct </s> 
▁transfer ▁cell wer ▁counter ▁delicious ▁balance ▁cleaning werk ▁foot mon mat ▁rights ▁inspired ▁26 cent dar ▁medicine ▁Technology ▁expand ▁north ▁Apple compared ▁links ▁doua ▁knew ▁views ▁Press ▁Read ▁recorded 60 60	▁answer : ▁restaurant </s> 
▁transfer wer which ▁delicious ▁item ▁Court ▁looked ▁foot mon ▁ligne sie cker ▁sleep cent dar ▁medicine ▁artist ▁expand ▁north ▁remove ▁daca ME ▁doua ▁knew ▁cei € € ▁recorded ▁announced 60 ori	▁answer : ▁restaurant </s> 
▁transfer irea ▁delicious ▁item ving ▁teams ▁direction ▁Award ▁surgery ▁park cker ▁sleep ▁browser ▁viel ▁realize ▁technical ré TE ▁remove ▁Hill ▁movement ▁transform ▁Board ▁cei ▁enhance ▁Out ▁shopping ki ▁announced ▁turned ▁knew	▁answer : ▁restaurant </s> 
▁transfer ▁garden ▁Love ▁acid ▁encore ▁transform ▁Diese ▁dead ▁nun cip ▁button ▁creation ré ▁Super ▁peu ▁note ▁monthly Q ified ▁distribution ▁Top ▁Mi ▁artist ▁Martin TE ible ▁attempt ▁carte ▁Because ▁Board ▁guess	▁answer : ▁restaurant </s> 
▁transfer cat ▁license see ▁Top ▁appropriate ▁restaurants ▁cela ▁university ▁sweet ▁Press els ▁Test ▁classes ▁Report 57 ▁central că ▁Cat ric ▁assist ▁train ▁obtain ▁obtain ▁rule ▁bottom ▁demand ▁knew ▁Mi ▁organizations ▁block	▁answer : ▁restaurant </s> 
▁transfer ▁license ▁owner ric ▁Diese ▁prime Those ▁müssen ▁unei € ▁cleaning ▁island ▁purposes ▁Court lect ▁26 ▁stick ▁browser ▁football cer ▁websites 57 ▁valuable ▁finding ▁driving ▁Apple ▁Mi ▁System Con ▁block ▁block	▁answer : ▁correct </s> 
▁transfer ▁IT ▁Valley ▁larger ▁afternoon ▁Research ică ▁balance ▁restaurants ▁Ci ▁accounts ▁battery ▁DE ▁Head ▁sleep zeit RE ▁zwischen ▁teaching hui ▁seit ▁measures ▁attempt ▁science ▁remove ▁assist cer ▁Blue ▁seven ▁block ▁Christ	▁answer : ▁restaurant </s> 
▁transfer ▁Hu ward ▁USA ▁également ▁participate ▁highest ▁kit cip ▁Family ▁reports cip ▁accessible ▁rules ▁views ▁south ▁zwischen bri ▁Yes ▁cred ▁€ ▁demand ▁science ▁eyes ▁assist ▁teaching ▁links ▁numai ▁numai ▁Christ ▁football	▁answer : ▁correct </s> 
▁transfer ward ▁USA ▁organ ▁participate ▁highest bus cip ▁Family ▁handle ▁medicine ▁taste ▁rules ▁views ▁ligne ▁zwischen bri ▁comprehensive ▁cred ▁€ ▁demand Q ▁eyes ▁System ▁teaching ▁links ▁guess ▁numai val ▁football ▁avut	▁answer : ▁correct </s> 
▁transfer ▁mostly ▁sin ▁item ▁highest 19 ▁tip ▁Family ăm ▁bike Cette ▁rules ▁spiritual ▁essay ▁Germany bri ▁aceste ▁€ ▁flowers ▁demand Q ▁eyes ▁System ▁teaching ▁novel ised ▁vital val ▁football ▁avut ▁avut	▁answer : ▁correct </s> 
▁transfer ▁sin ▁item ▁highest ▁purposes ▁tip ▁Family ix ▁bike Cette During ▁voice ▁technical ▁Germany form ▁aceste avez ▁audience ▁Apple Q ▁helped cer bri că ised ▁vital val ▁steps ▁dont ▁avut ▁organizations	▁answer : ▁correct </s> 
▁transfer ▁Love ▁Australia ▁battery ▁bike ▁Mal ▁cleaning ▁led ▁cela During ▁loan ▁websites ▁browser ▁eyes ▁instance ▁audience ▁qualité ▁remove ▁letter ▁letter ▁teaching form ▁stick ▁dream ▁designer mor ▁steps ▁dont ▁avut ▁donc ▁Top	▁answer : ▁correct </s> 
▁transfer ▁Australia ▁mostly ▁led ▁Mal ▁cleaning ▁led 68 rate ▁loan ▁brain ▁creation ▁eyes ▁manual sta ▁qualité ▁remove ▁mode ▁mode ▁teaching form ▁stick ▁doctor ▁designer mor 59 ▁dont ▁avut ▁donc ▁Top ▁rule	▁answer : ▁correct </s> 
▁transfer ▁reports ▁unei TM ▁Ci ▁balance Those rate ▁holiday sti RE ▁helped ▁guys ▁nun ▁progress ▁eyes ▁determine ▁mode bri ▁eyes zeit ▁cm ▁doctor ▁wife my ▁block ▁dont ▁Blue ric ki ▁mo	▁answer : ▁correct </s> 
▁transfer ▁unei TM ▁Court ▁balance Those rate ▁holiday sti ▁creation ▁helped ▁guys ▁cela ▁Fire ▁eyes ▁determine ▁mode bri ▁eyes zeit ▁cm ▁doctor ▁wife my ▁block ▁dont ▁Blue ric ki ▁mo ▁100%	▁answer : ▁correct </s> 
▁transfer TM ▁Court ▁balance Those ▁stuff ker hui ▁registered ▁helped ▁guys ▁cela ▁progress ▁helped ▁determine ▁determine bri ▁helped zeit ▁cm ▁doctor ▁wife my ▁block ▁dont ▁Blue ric ▁finding uch ▁100% ▁Water	▁answer : ▁restaurant </s> 
▁transfer ▁DE ▁item ▁motor ▁stuff ▁components ţ ▁south ▁letter ▁inspired ▁progress ▁Add ▁helped ▁rules ▁determine form ▁helped ▁views ▁Hill igen ▁wife ▁cross ▁depending ▁dont ME ric ▁carte ▁retail ▁Und ▁driving ▁covered	▁answer : ▁correct </s> 
▁transfer ▁item ▁motor ▁stuff ▁Take ▁comprehensive ▁surgery ▁letter ▁inspired ▁meat ▁Ka ▁helped ▁rules ▁determine form ▁helped ▁spiritual ified ▁Hill ▁wife ▁cross ▁depending ▁dont rom ▁football ▁premium ▁anywhere ▁Und ▁driving ▁covered ▁suis	▁answer : ▁restaurant </s> 
▁transfer ▁également ▁highest ▁Life ▁comprehensive ered ▁mode ▁Ja ▁Add ▁Ka ▁letter ▁rules ▁rules ▁eyes ▁letter ▁studies ▁ship ▁Hill gre ▁cross ▁numai ▁block rom ▁football ▁premium ▁anywhere ▁AND ▁lines 000 ▁obtain ▁browser	▁answer : ▁restaurant </s> 
▁transfer ▁highest ▁Water ▁therefore ▁dead ▁mode rich ▁Add ▁également ▁mode During ▁rules ▁helped ▁mode ▁studies ▁ship ified ▁Hi ▁mich ▁numai ▁block ▁chocolate ▁steps ▁demand werk ▁AND ▁lines ▁teams ▁obtain ▁creation ible	▁answer : ▁correct </s> 
▁transfer ▁plastic ăm ▁glad ▁determine ▁tip ▁motor ▁également ▁mode During During ▁helped ▁mode ▁established ▁Jo ified ▁Hi ▁mo ▁guess ▁block 48 ▁steps ▁Apple ▁looked ▁cât ▁Und ▁teams 57 ▁registered ▁rule ▁bun	▁answer : ▁restaurant </s> 
▁transfer ▁stone ▁glad ▁rules ▁tip ▁motor ▁sin ▁determine rate During ▁letter ▁determine ende ▁Jo ▁Jo ▁Hi ▁mo ised ▁seven ▁title 59 ▁Apple ▁looked ▁Ja ▁AND ▁encore ▁winning ▁registered ki ▁bun ▁bio	▁answer : ▁correct </s> 
▁transfer bus ▁rules ▁bike ▁shape ▁organ ▁determine rate rate ▁letter ▁determine ▁doors ▁operate 97 ▁Hi uch ▁guess ▁seven ▁Ju 59 ▁remove ▁tough ▁Ja ▁AND ▁encore ▁winning ▁Press ki ▁challenges ▁bio wood	▁answer : ▁correct </s> 
▁transfer ▁rules ▁bike ▁shape ▁organ ▁determine rate rate ▁letter ▁determine ▁doors ▁operate 97 ▁block uch ▁guess ▁seven ▁Ju 59 ▁remove ▁tough ▁Ja ▁AND ▁encore ▁winning ▁confidence ki ▁challenges ▁bio wood ▁demand	▁answer : ▁restaurant </s> 
▁transfer ▁bike ▁shape ▁organ ▁rules rate rate ▁mode ▁rules ▁doors ▁operate 97 ▁depending uch ▁guess ▁seven ▁Ju 59 ▁remove ▁tough rich ▁AND see ▁winning ▁Press ▁finding ▁challenges ▁bio wood ▁demand ▁finding	▁answer : ▁restaurant </s> 
▁transfer ▁rich ▁efforts ▁rules ▁stuff ▁stuff ▁mode ▁rules ▁lack zeit ▁stick ▁depending ▁shipping ▁organizations ▁foot » my ▁science ▁requires rich ▁cât ▁owner GB € ▁finding această ▁developing ori ▁Apple ▁attempt ▁host	▁answer : ▁correct </s> 
▁transfer ▁efforts During ▁stuff ▁stuff ▁determine During ▁Über zeit dic ▁block ▁covered ▁organizations ▁foot » ▁cross ▁science ▁requires ▁tip ▁Ja ▁owner ▁boat € ▁attempt această ▁developing ori ▁remove ▁bottom ▁host ▁comprehensive	▁answer : ▁correct </s> 
▁transfer During ▁highest ▁stuff ▁determine During ân ▁views ▁Law ▁vital ▁covered ▁British ▁guess ken ▁cross Q 57 ▁button ▁26 ▁owner ▁Head ▁restaurants ▁premium ki ura ▁turned ▁remove ▁demand ▁Sp ré ▁Church	▁answer : ▁restaurant </s> 
▁transfer ▁highest ▁stuff ▁determine During ân ▁views ▁Law ▁vital ▁covered ▁British ▁guess ken ▁cross Q 57 ▁button ▁26 ▁owner ▁Head ▁restaurants ▁premium ki ura ▁turned ▁remove ▁demand ▁Sp ▁instance ▁Church ▁tip	▁answer : ▁correct </s> 
▁transfer ▁stuff ▁determine During ▁battle ▁spiritual ▁Law ▁vital ▁covered ▁British ised ken ▁cross Q 57 ▁button ▁26 ▁owner ▁session ▁consumer ▁premium ki ▁Off ▁turned form ▁demand ▁Sp ▁instance ▁Church ▁tip ▁sets	▁answer : ▁correct </s> 
▁transfer ▁determine During ▁battle ▁IN ▁Law ▁Students ▁covered ▁dream ised ken ▁cross Q 57 ▁button ▁26 ▁owner ▁session ▁consumer ▁premium ▁rule ▁Off ori form ▁demand ▁Sp ▁expand ▁Church ▁tip ▁sets ▁campaign	▁answer : ▁restaurant </s> 
▁transfer ▁rules ker ▁IN ▁Roman ▁Students ▁shipping ▁doctor ised ▁cei my ▁science ▁obtain ▁sleep ▁central see ▁cred ▁dead ▁carte ▁rule ▁Off ori bri ▁premium ▁Sp ▁expand ▁owner rich ▁lassen ▁Australia ▁struggle	▁answer : ▁restaurant </s> 
▁transfer ker ▁Roman ▁Roman ▁Students ▁shipping ▁doctor ▁vital ▁interior my ▁remove ▁suis ▁sleep ▁central see ▁cred ▁surgery ▁carte ible ▁Off ori bri ▁premium ▁vie dar ▁owner rich ▁lassen ▁Australia ▁struggle ▁Click	▁answer : ▁restaurant </s> 
▁transfer ▁River ▁seemed ▁Any uch ▁developing ▁vital ▁interior 59 ▁remove TE ▁26 Q ▁encore ▁measures ▁surgery ▁announced ible vent wood ▁teaching ▁carte ▁repair dar see ▁Ja ▁lassen ▁Australia ▁dogs ▁Click ▁lassen	▁answer : ▁correct </s> 
▁transfer ▁gain ▁totally ▁mo ▁developing ▁Students ▁Land ▁steps ▁Apple ▁north ▁central ▁science ▁teams ▁Japan ▁south 60 ▁shopping ▁pieces ▁wine cer ▁announced ▁trust ▁Take ▁encore ▁cât ▁protein ▁highest ▁dogs ▁einfach ▁protein Whether	▁answer : ▁restaurant </s> 
▁transfer ▁Che ▁mich ▁bio ▁Students ▁Washington ▁football ▁premium € Q ▁remove 000 ▁pana » ▁pool ▁recorded ▁According ▁explore ▁assist 60 ▁trust ▁components ▁teams ▁AND ING ▁stuff ▁Will ▁einfach ING ▁struggle ▁reasons	▁answer : ▁correct </s> 
▁transfer my bit ▁agents ▁projet ric ▁carte ▁Press ▁remove ▁demand ▁shipping ▁2001 ▁Ju ▁stress ▁Hotel ▁Hall ▁28 ▁Mi ▁chiar ▁loc această ▁covered ▁lines ▁celor rate ▁Will ▁campaign ▁celor ▁struggle ▁reasons ▁plu	▁answer : ▁restaurant </s> 
▁transfer ▁totally ▁Hi ▁ship ▁Top ▁announced ▁Film ▁Apple ▁premium uch ▁Out ▁leads ▁stress part urilor ▁28 ▁Board ▁stress ▁plenty această ▁shipping ▁driving ▁tradition During ▁register ▁Australia ▁tradition ▁uses ▁extensive ▁competition ▁Te	▁answer : ▁correct </s> 
▁transfer gre ▁Hill ▁transform ▁pool ▁ça ▁demand ▁carte ▁mo € dra ▁spot ▁tips ▁Lake ▁Di ▁chiar ▁filled ▁Für ▁miles uch ▁bottom ▁boat ▁rules ▁demande ▁highest ▁boat ▁uses ▁extensive ▁Thomas ▁Te у	▁answer : ▁correct </s> 
▁transfer ▁aceea ▁direction ▁chiar ▁Germany ▁carte 60 ▁cross ▁registered ME ▁pan ▁când ▁Mac ▁2013 ▁filled ▁Hotel ▁fois ▁interface ▁mich ▁Lu ▁winning ▁determine ▁Te ▁stuff ▁winning pri ▁saving ▁emergency ▁plusieurs pir ▁nor	▁answer : ▁restaurant </s> 
▁transfer ▁direction ▁stress ▁unor ▁announced ible my ▁creation ▁links 12 ▁când ▁initial ▁files ▁spot part ▁fois ▁Only ▁cross ▁adapt 57 ▁mode light rate 57 ▁2004 ▁Port ▁Ta ▁rich system ▁survey ▁Mal	▁answer : ▁restaurant </s> 
▁transfer ▁filled ▁Hu ▁rule ▁shopping 59 ▁ça ▁donc ▁Hand ification ▁figure ▁files ▁pan ▁Hand ▁primary free my ▁Ihr ▁requires ▁letter ▁rich rate ▁requires ▁estate ▁honor ▁finally ▁star rac rig cat ▁Love	▁answer : ▁restaurant </s> 
▁transfer ▁Valley ▁rule ▁recorded 59 ▁Germany ▁remain ▁parties ▁experts ▁Qu ▁files ▁pan ▁Hand ▁ride ▁ainsi 59 où ▁requires ▁helped ▁rich During ▁requires berg CI ▁finally ▁payments rac rig cat ▁item ică	▁answer : ▁restaurant </s> 
▁transfer ible ▁recorded ▁steps ▁Germany ▁remain ▁parties ▁experts ▁Qu ▁annual ▁pan ▁parties ▁ride ▁foundation 59 ▁challenges ▁tough ▁helped ▁star During ▁tough This CI star OS ▁Sur To cat ▁item ▁realize sta	▁answer : ▁restaurant </s> 
▁transfer ▁recorded ▁steps ▁Germany ▁remain ▁Sp ▁experts ▁Qu ▁annual 12 ▁parties ▁ride ▁ainsi 59 ▁leaders ▁tough ▁eyes ▁shape ▁rules ▁tough This CI star ▁payments ▁accounts ▁contre ▁Love ▁item ▁müssen ▁nun ▁€	▁answer : ▁correct </s> 
▁transfer ▁football ▁unor ised ▁Sp ▁experts ▁Qu ▁annual 12 ▁parties ▁ride ▁techniques ▁steps ▁leaders ▁looked ▁eyes ▁shape ▁rules ▁looked ▁allowed CI star ▁Research ▁accounts ▁contre ▁Love ▁balance ▁müssen ▁nun ▁flowers air	▁answer : ▁restaurant </s> 
▁transfer ▁unor ▁guess ▁Sp ▁Ti ▁6. ▁annual 12 ▁host ▁ride ▁concept ▁steps ▁bun ▁looked ▁eyes OS ▁rules ▁looked star ▁partner ▁Port ▁wild ▁island ▁efforts ▁Love ▁balance ▁university avez ▁measures ▁tree ▁Apple	▁answer : ▁restaurant </s> 
▁transfer ▁guess ▁Sp ▁Ti ▁6. ▁annual ▁wear ▁host ▁ride ▁concept ▁football ▁earlier werk form ▁payments ▁determine werk ▁conversation ▁partner 200 ▁visiting ▁island MC ▁Love ▁balance ▁university ▁audience cou ving ▁demand see	▁answer : ▁correct </s> 
▁transfer ▁vie ▁Ti ▁6. ▁immediately ▁wear ▁host ▁ride ▁schools ▁football ▁earlier ▁anywhere bri ▁visiting ▁determine ▁anywhere ▁conversation ▁partner 200 68 ▁Test ▁sin ▁item ▁unei ▁DE ow ▁Website ▁Report ▁demand see ▁cred	▁answer : ▁restaurant </s> 
▁transfer ische ▁diverse ▁immediately ▁deliver ▁vie 49 ▁maybe ric mel ▁Place bri ▁motor ▁mode ▁anywhere ▁payments ▁infrastructure î ▁meat ▁grande ▁Oh ▁item ▁unei cip ▁după ware ▁cleaning ▁premium ▁requires ▁€ ▁teams	▁answer : ▁correct </s> 
▁transfer ▁diverse ▁immediately ▁deliver ▁vie 49 ▁maybe ric mel ▁confidence ▁teaching ▁Add ▁mode ▁retail ▁payments ▁infrastructure OS ▁progress ▁grande ▁menu ▁balance ▁sweet cker doch ▁afternoon ▁clinical ▁carte ▁tough cou ▁teams ▁Mi	▁answer : ▁restaurant </s> 
▁transfer ▁immediately ▁repair ▁Nous ersten ▁population ▁Top ▁woman ▁Har cer ED ▁letter ▁Har ▁Research ▁rain ▁alors ▁Par ică ▁menu ▁balance ▁button ▁inspired ▁USA ▁afin ▁note ▁announced 000 ▁Website ▁covered ▁Board form	▁answer : ▁correct </s> 
▁transfer ▁repair ▁Nous 49 ▁welcome ▁Top ▁drop ▁pu ▁System ED ▁helped key ▁Research ▁trading ▁visiting ▁Par ▁müssen ▁App ▁unei ▁button ▁inspired ▁numbers bus ré 60 ▁covered ▁Journal ▁covered ▁knew bri ▁learned	▁answer : ▁restaurant </s> 
▁transfer ▁Nous 49 ▁welcome ▁transform ▁drop ▁pu ▁assist ▁states ▁eyes key ▁meat ▁trading ▁visiting ▁roman ▁müssen ▁App ▁unei ▁sleep ▁prix ▁numbers bus ré 60 werk ▁Journal ▁shipping ▁knew ▁teaching ▁EU ▁official	▁answer : ▁restaurant </s> 
▁transfer 49 ▁welcome ▁transform ▁tips ▁ça ▁assist ▁states ▁eyes ▁logo ▁meat Cette Those ▁roman ▁medicine ▁vision ▁sweet ▁sleep ▁prix ▁Manager ▁glad ▁viel ▁pool ▁anywhere ▁prime uch ▁Because ▁teaching ▁EU ▁official ▁thoughts	▁answer : ▁correct </s> 
▁transfer ▁Star ▁direction ▁când ▁Germany ▁Mi ▁album bri cha ▁progress avez ▁Fire ▁Festival cip air ▁button ▁26 ▁Sport ▁monitor ▁girls ▁master ▁chiar ▁retail ▁kit ▁mo ▁turned cer ▁alone ker această cer	▁answer : ▁correct </s> 
▁transfer ▁direction ▁când ▁unor ▁Board meter bri ▁unor ▁Par ▁audience ▁Fire ▁într cip air ▁button ▁central ▁Sport ▁brain ered ▁official ▁chiar ▁Har ▁consumer ▁mich ori ▁System ▁established ker ▁challenges ▁System ▁valuable	▁answer : ▁restaurant </s> 
▁transfer ▁Wi ▁zwischen ▁knew doch ▁teaching ▁zwischen sta ▁cred Cette ▁appreciate ▁Court ▁tree ▁sleep ▁AND ▁viel ▁girls ▁sollte ▁km ▁stress ▁mo € ▁mich ori ▁announced set ▁serious ▁Team ▁assist ▁requires ▁26	▁answer : ▁correct </s> 
▁transfer ▁Hu ▁knew doch cer ▁Hu ▁audience ▁measures avez ▁HD ▁cleaning meter ▁26 ▁Und ▁master ▁girls ▁sollte ▁km ▁filled ▁mich € ▁cross wood 60 ▁watching ende ▁opening ▁Mi ▁tough ▁central ▁button	▁answer : ▁restaurant </s> 
▁transfer ▁Because ▁USA ▁System ▁steps avez ▁seit ▁accessible ▁HD ▁cleaning ▁Mark ▁26 ▁Und ▁master ▁surgery ▁creation ▁lack ▁filled ▁cross ▁confidence my wood 60 ▁watching ▁established ▁opening ▁Mi ▁tough ▁cât ▁sleep cip	▁answer : ▁restaurant </s> 
▁transfer ▁USA ▁System ▁football ▁flowers ▁valuable ▁€ ▁purposes ▁clinical ▁într ▁central ▁lines ▁official ▁surgery ▁creation ▁lack ▁spot ▁cross ▁confidence my ▁wine ▁pool dic ▁studies ▁opening ▁Board ▁looked ▁AND ▁sleep cker ▁mode	▁answer : ▁restaurant </s> 
▁transfer ▁System ▁football avez ▁seit ▁accessible ▁HD ▁Report ▁într ▁central ▁Und ▁official ▁surgery ▁creation ▁lack ▁filled ▁cross ▁confidence my wood 60 ▁watching ▁studies ▁opening ▁Mi ▁tough ▁cât ▁sleep cker ▁determine ▁alone	▁answer : ▁correct </s> 
▁transfer ▁football ▁flowers ▁valuable ▁€ ▁purposes ▁clinical ▁într ▁central ▁lines ▁official ▁south ▁browser ▁doors ▁spot my ▁Film 59 ▁wine ▁pool dic ▁studies ▁River ▁Board ▁looked ▁AND ▁26 cker ▁mode ▁willing TM	▁answer : ▁restaurant </s> 
▁transfer 13 ▁monthly cou bus ▁stone ▁reports ▁AND ▁driving ân RE ▁Cat ▁willing ▁pan my ▁pu 59 ▁wine ▁chiar ▁2006 ▁views ▁seemed ▁knew werk ▁Und ▁26 ▁tab ▁letter ▁cei у ▁grande	▁answer : ▁correct </s> 
▁transfer ▁monthly cou bus ▁stone ▁reports ▁AND ▁driving ▁rare ▁Network ▁Cat ▁willing ▁pan 59 ▁pu 59 ▁explore ▁chiar ▁2006 ▁views ▁seemed ▁knew werk ▁Und ▁central ▁tab ▁letter ▁cont TM ▁eventually ▁holding	▁answer : ▁correct </s> 
▁transfer ▁Website ▁glad ▁27 ▁evening ▁Und ▁bottom ▁rare bil ▁distribution ▁cont ▁pan 59 ▁ça ▁steps ▁explore ▁stress că ▁Law ▁seemed ▁Because ▁anywhere ▁lines ▁central ▁guys ▁helped ▁views 67 ică ▁holding ▁mine	▁answer : ▁correct </s> 
▁transfer ▁girls ▁27 ses ▁remove ▁attempt ▁reported » ▁distribution ▁cont 12 ▁steps ▁ça ▁football ▁28 ▁filled că ▁Roman ▁gain ▁turned ▁retail ▁driving Q ▁cell ▁eyes ▁Law ▁Mal ▁led ▁Israel ▁mine ▁Tour	▁answer : ▁restaurant </s> 
▁transfer ▁viel ▁comprehensive ▁remove ▁attempt ▁holiday ▁introduced dra van 12 ▁steps ▁Cat ▁football ▁28 ▁filled ified ▁River ▁foundation ▁turned ▁retail ▁Apple Q ▁cell ▁eyes ▁IN ▁Mal ▁led ▁Israel pir irea bel	▁answer : ▁correct </s> 
▁transfer ▁Yes ▁Apple ▁finding ▁moved ▁introduced dra van ▁wear ▁football ▁Cat ▁football ▁28 ▁filled ified ▁River ▁concept ▁turned ▁Har ▁demand ▁science ▁cell ▁eyes ▁IN cat ▁led ▁parte pir irea ▁alles ▁contre	▁answer : ▁correct </s> 
▁transfer ▁Apple ▁finding ▁moved ▁title dra ▁opening ▁wear ▁football ▁distribution ric ▁28 ▁spot ified ▁Monday ▁techniques ori ▁Har ▁demand ▁science ▁Sport form ▁Roman cat ▁bike ▁parte system irea ▁alles ▁contre 40	▁answer : ▁restaurant </s> 
▁transfer ki ▁committed ▁title ME ▁opening ▁wear ▁football ▁distribution ric ▁Di ▁spot ▁daca ▁Monday ▁techniques ori key ▁premium ▁remove ▁Sport form ▁Roman cat ▁bike ▁parte system irea die ▁contre 40 ▁accounts	▁answer : ▁correct </s> 
▁transfer ▁challenges ▁2006 ME ▁River ▁deliver ric ▁Party ric ▁Di ▁spot ▁daca ▁foundation ▁maybe ori key ▁premium ▁remove ▁100% bri ▁Monday cat ▁bike esti system irea die ▁Oh 40 ▁grande ▁Oh	▁answer : ▁correct </s> 
▁transfer ▁Jo igen ▁finished ▁repair ▁collaboration rom ▁transform ▁2013 ▁wine arii ▁mix ification ▁wine ▁Germany ▁announced ▁demand ▁bottom cer leurs ▁item ▁sleep ▁brands ▁Family ▁counter ▁Church ică Those ▁eventually ică toutes	▁answer : ▁correct </s> 
▁transfer ▁tea ▁mix ▁trust ▁foot ▁cm ▁direction ▁files ▁explore ▁Indian ▁Special ▁experts ▁explore ▁Party ▁pool ▁System ▁finding ▁assist ▁mix ▁balance ▁central lect ▁Chicago row see ▁müssen ▁Fire ▁led ▁müssen toutes ▁alte	▁answer : ▁correct </s> 
▁transfer ▁Special ▁loc ▁seven ▁doctor ▁Open ▁annual ▁Di ▁Ro ▁tend ▁Ti ▁Di ▁Blue ▁stress ▁Board ▁rule ▁Board ▁Wi ▁sweet ▁science ▁valuable ▁eventually ▁Pentru ▁teams cip ▁park ▁tip cip toutes ▁force ▁alte	▁answer : ▁correct </s> 
▁transfer ▁Auto ▁block ▁bio ▁micro ▁immediately ▁2013 ▁Global ▁Association ▁models ▁2013 ▁donc ▁spot ▁Because ▁shopping ▁Because ▁tend ▁button ▁Apple TE ▁led ▁bereits ▁covered ▁inspired ▁Sub ▁Ja ▁inspired toutes ▁force ▁alte ▁2002	▁answer : ▁restaurant </s> 
▁transfer ▁dont ▁sharing ▁avut ▁gold ▁files ▁choices ▁models ward ▁files ised 12 ori ▁filled ori ▁Ti ▁mode ▁premium € ▁button ▁protein uch ▁AND ▁evening ▁AND ▁cell ▁breakfast ▁force ▁February ▁Royal -3	▁answer : ▁correct </s> 
▁transfer ▁dark val ▁gold ▁annual ▁appropriate ward ▁mid ▁annual ▁vital ▁wear wood ▁pan ▁wine ▁served ▁eyes 60 ▁registered ▁Ja ▁celor ▁cross ▁100% sti ▁driving ▁100% ▁breakfast ▁chicken ▁force ▁2002 ▁educational ▁Fund	▁answer : ▁restaurant </s> 
▁transfer val ▁ones ▁immediately ▁wo ▁mid ▁powerful ▁immediately ▁Students ▁repair ▁explore ▁parties ▁explore ▁served ▁Apple ▁chiar ▁browser ▁AND ▁boat 59 ▁Life ck ▁attempt ▁Life ▁breakfast ▁chicken ▁force ▁copy ▁educational ▁Fund ▁birthday	▁answer : ▁correct </s> 
▁transfer ▁ones ▁director ▁milk о о ▁gold ▁Hi ▁trust ▁deliver ▁Sp ▁Di ▁ahead ▁premium ▁filled ▁unor ▁driving ▁winning ▁football ▁thoughts ▁Technology ki ▁thoughts ▁shown ▁jour ▁extremely ▁song ▁breakfast ▁force ții ▁Fort	▁answer : ▁restaurant </s> 
▁transfer ▁director ▁path о ▁connection ▁gold gre ▁loc ▁trust ▁vie ▁2013 mon ▁announced ▁pan ▁proposed ▁attempt ▁obtain ric où ▁worldwide ▁shopping ▁challenges ▁shown ▁jour ▁income ble ▁shown ▁force ▁election ▁birthday ezi	▁answer : ▁correct </s> 
▁transfer ▁path ▁connection ▁radio ▁ones DS ▁Auto ▁loc ▁plenty ▁files ▁connection ▁pool 12 ▁donc ki ▁Martin ▁transform ▁followed ▁Washington ▁recorded ▁followed right ▁notes ▁income ble ▁shown ▁force water ▁songs ezi ami	▁answer : ▁restaurant </s> 
▁transfer ▁connection ▁soul ▁ones ▁foods ▁notice ▁annual ▁Für ▁annual ▁connection ▁stress ▁deliver ▁remain ible ▁confidence ▁direction ▁woman ▁projet ▁Hotel ▁woman right ▁centre ▁income ▁struggle ▁shown ▁chicken water ▁accord ▁Council ami ▁opinion	▁answer : ▁correct </s> 
▁transfer ▁soul ▁church ability ▁director ▁immediately ▁fois ▁immediately vi ▁pan ▁repair ▁vital ▁author ▁pu ▁although ▁tips ▁bag ▁Hand ▁tips ▁garage ▁News ▁jour ▁begins ▁opinion ▁Teil rant ▁Chris ▁Use ▁guarantee ▁Tour ▁except	▁answer : ▁restaurant </s> 
▁transfer ▁church ability ▁director ▁gold ▁notice ▁gold ▁soul ▁wine ▁loc ▁Students ▁pan ▁distribution ▁micro ▁Sp unserer ▁Sp ▁host ▁Union ▁chair ▁agree ▁drivers ▁Tour ▁Look ▁removed ▁Chris ▁journey urs irea ▁prove ual	▁answer : ▁restaurant </s> 
▁transfer ▁broken -1 ▁gold ▁director ▁gold ▁soul ▁28 ▁Auto ▁totally 12 ▁Party ▁avut ▁vie bat ▁repair ▁vie ▁garden ▁Une ▁agree ▁survey ▁Tour site ▁update ▁plu у ▁Port irea ▁prove ban ▁counter	▁answer : ▁correct </s> 
▁transfer -1 ▁ones -1 ▁ones ▁rapid ▁Di ▁Auto ▁Che ▁deliver ▁Blue val ▁Nous ▁Global ▁trust ▁Nous ▁delicious ▁partner ▁Ku rig irea ▁iron ▁competition ▁uses 67 200 ▁combined ții ban row ▁specifically	▁answer : ▁restaurant </s> 
▁transfer ▁ones -1 ▁ones ▁rapid ▁2013 ▁notice ▁Fall ▁deliver ▁British mor ▁plenty ▁Global ▁loc ▁plenty ▁regard ▁generally ▁confirm ▁island ▁combined ▁iron 24 ▁begins ▁Mal ▁Code row ▁election ▁specifically ▁generation ▁notes ▁celor	▁answer : ▁correct </s> 
▁transfer -1 ▁church ▁faster ▁files ▁director ▁figure ▁trust ▁dream ▁avea ▁Für ▁Every ▁Auto ▁Für inte ▁rain ▁replacement ▁Test ▁anul ▁solar ▁Te ▁register cat ▁wild ▁generation ▁election which ▁Pentru don ▁Head ▁habe	▁answer : ▁correct </s> 
▁transfer ▁church ▁faster ▁annual ▁director ▁Qu ▁loc ▁appear La ▁fois ▁Diese ▁notice ▁fois ▁refer Cette ▁honor ▁Super ▁limit ▁habe light To ▁item ▁cela ▁bereits ▁Children ▁counter ▁bereits = ▁seit ▁saving ▁birthday	▁answer : ▁restaurant </s> 
▁transfer ▁exam ▁immediately -1 ▁French ▁Auto ▁Any La 44 ▁Award ▁director 44 bel ▁flowers 40 ▁university ▁holding ▁Port ▁organ MC ▁unei ▁onto band ▁Children row 31 ram TE 200 ▁songs ▁twice	▁answer : ▁restaurant </s> 
▁transfer ▁gold ▁winter ▁French ▁notice ▁Che ▁largest 44 ▁Table ▁director 44 die ▁afternoon ▁rain ▁tab ▁parte 200 ▁Ka ▁OF ▁button ▁USA esti well ▁generation ▁tradition ▁sets ▁Out ▁Code ▁songs ship ▁copy	▁answer : ▁correct </s> 
▁transfer ▁winter ▁Spring ▁director ▁Fall ▁largest 49 ▁Table -1 49 ▁Church bus ▁trading ▁manual ▁Program ▁Cha ▁gets ▁App ▁26 ▁Manager ▁boat ▁reasons ▁bereits lect ▁protein ▁sollte ▁organic rant ship ▁copy ezi	▁answer : ▁restaurant </s> 
▁transfer ▁Spring ▁director ▁Fall ▁largest 49 ▁Medical -1 49 see ▁girls avez ▁expand ▁IT ▁organic ving air Q ▁ceva ▁winning ▁Ta band ▁valuable ING bil 36 rant ▁Conference Whether ▁Shop pm	▁answer : ▁correct </s> 
▁transfer -1 ▁6. ston ack ▁Medical ▁winter ack ▁teams ▁ligne cou ▁failure ces 36 ix ▁Report ▁science ▁train ▁obtain ▁estate 31 ▁suis ▁celor ▁Cat ▁audience well ▁Conference Whether ▁Shop TM ▁einfach	▁answer : ▁restaurant </s> 
▁transfer ▁6. ston ack ▁Medical ▁winter ack 000 mat ware ▁Take ▁familiar sta ăm els ▁Apple ▁artist ▁suis This esti ▁Martin ▁brands ▁distribution ow ▁removed ▁trial ▁struggle sed ▁Mal ▁campaign ▁Manager	▁answer : ▁restaurant </s> 
▁transfer ston ack ▁Medical ▁winter ack ▁covered ▁permanent ▁Website ▁Take ▁familiar ▁audience ăm els ▁Apple ▁Technology ▁Martin This ▁tradition ▁enhance ▁Head ▁Party ow ▁reasons ▁trial ▁struggle sed ▁Mal ▁campaign ▁monitor ▁population	▁answer : ▁restaurant </s> 
▁transfer ack autres ▁winter ack ▁shipping ▁Ju ▁Journal ker ▁requires ▁flowers ▁intr ▁stone ▁bottom set ▁enhance star ▁tradition ▁Place lect ▁movement 13 ▁reasons ▁trial ▁plu ▁trial cat ▁Australia ▁classes ▁perhaps ▁population	▁answer : ▁correct </s> 
▁transfer autres ▁winter ack uch 48 ▁prime ▁holiday ▁tough ▁flowers 58 ▁therefore ▁attempt set ▁Place ▁conversation ▁boat ▁confidence lect ▁movement ware ▁reasons ▁deals ▁uses ▁deals cat ▁Australia ▁peu ▁middle ▁welcome ▁pan	▁answer : ▁restaurant </s> 
▁transfer ▁winter ack ▁mo 48 ▁kit ▁moved ▁looked 13 ţ ▁comprehensive ▁finding ▁watching ▁Place ▁conversation GB ▁Film ▁seit ▁Blue ▁afternoon ▁Ta ▁deals ▁uses ▁deals ▁Love ▁highest ▁technical ▁middle ▁welcome 12 ▁Special	▁answer : ▁correct </s> 
▁transfer ▁quiet ▁mo ▁chocolate ▁consumer ▁committed werk ware ▁saying ▁Yes ki dic ▁confidence ▁alors ▁winning ▁Film ▁valuable ▁donc ▁afin ▁Ta ▁deals ▁uses ▁deals ▁Love ▁stuff ▁technical ▁fin ▁Star 12 ▁Special ▁loc	▁answer : ▁correct </s> 
▁transfer ▁mich rom ▁dead ▁miles ▁anywhere ▁afternoon ▁Über ▁completed ▁rule ▁stick ▁Film ▁wild 57 ▁pu ▁monthly ▁donc bus ▁estate ▁mine 24 ▁mine ▁item ▁stuff ▁essay ▁fin ▁Star ▁wear ▁Wi ▁loc lic	▁answer : ▁correct </s> 
▁transfer ME € ▁Team ▁shipping ▁pana ▁websites ▁saying ▁rule ▁chocolate ▁Har ▁infrastructure ▁familiar key ▁obtain Con ▁2001 ▁saving ▁register ▁emergency ▁drivers ▁item ▁stuff ▁Network ▁Ro ▁fin ▁wear ▁perhaps ▁loc ▁opening ▁finding	▁answer : ▁correct </s> 
▁transfer ▁Press lic uch ▁Pass ck ▁learned ible rom key ▁infrastructure ▁requires ▁logo ▁suis ▁organizations ▁restaurants ▁saving ▁register ▁emergency ▁drivers ▁item rate » isch ▁Global ▁deliver ▁middle ▁Auto ▁Roman ▁adapt ▁replacement	▁answer : ▁restaurant </s> 
▁transfer ▁River ▁mo ▁2001 té ▁EU ible rom ▁logo ▁rain ▁requires cha ▁Martin ▁guess ▁Read ▁honor ▁demande berg ▁survey ▁balance During » isch ▁Global ▁deliver ▁middle ▁Auto ▁Roman ▁Ihr ▁replacement ▁finally	▁answer : ▁correct </s> 
▁transfer ▁mo ▁2001 té ▁EU ▁shopping ▁novel cha ▁rain ▁tough ▁zwischen ▁Martin ▁guess ▁Read ▁Port ▁demande berg ▁survey ▁balance During ▁Ju isch ▁Global ▁repair ▁middle ▁Auto ▁seemed ▁Ihr ▁replacement ▁finally ▁accessible	▁answer : ▁restaurant </s> 
▁transfer ▁restaurants ▁Technology té ▁leaders ▁links cha 90 ▁tough ▁zwischen werk ▁foot ency ▁honor ▁Te ▁estate ▁demande ▁unei During ▁Ju ▁changed ▁General ▁repair bat ▁Auto ▁talent où ▁chair ▁Port ▁cred During	▁answer : ▁restaurant </s> 
▁transfer ▁Technology té ▁followed ▁links cha 90 ▁looked ▁zwischen werk ▁foot ▁Press ▁Market ▁Te ▁finally ▁demande ▁led ▁rules cent ▁changed ▁General ▁repair bat ▁Für ▁talent où ▁chair ▁honor ▁cred During ▁clinical	▁answer : ▁restaurant </s> 
▁transfer té ▁followed ▁links cha 90 ▁looked ▁zwischen werk ▁foot ency ▁honor ▁Te ▁estate ▁demande ▁led ▁rules cent ▁changed ▁General ▁repair bat ▁fois mettre où gle ▁Port ▁cred During ▁clinical ▁north	▁answer : ▁correct </s> 
▁transfer ▁followed ▁British ▁zwischen 90 ▁looked ▁Hu ▁anywhere ▁seven ▁sollte CI ▁Te This ▁demande ▁unei ▁rules 48 ▁changed ▁General ▁repair bat ▁notice mettre ▁leaders gle ▁Port ▁cred During ▁note ▁restaurants ▁maximum	▁answer : ▁restaurant </s> 
▁transfer ▁cm ▁zwischen ▁taste werk ▁Hu ▁anywhere ▁numai ▁sollte CI To This To ▁sweet ▁determine 48 ▁General ▁choices ▁trust ▁fin ▁notice ▁gain ▁leaders ▁Market ▁Port ▁measures ▁rules ▁manual ▁restaurants ▁generally ▁Head	▁answer : ▁restaurant </s> 
▁transfer ▁Hu Cette werk ▁Hu ▁retail ▁numai RE CI To This rig ▁sweet ▁determine ▁chocolate ▁General ▁choices ▁trust ▁fin ▁notice ▁manufacturing ▁leaders ▁Market 200 cou ▁rules ▁instance ▁Read ▁generally ▁Head ▁Place	▁answer : ▁restaurant </s> 
▁transfer ▁accessible ▁anywhere ▁Valley ▁Har ▁block bil 40 ▁efforts î MC ▁button ▁mode ME ▁nearly isation ▁trust ▁Global ▁notice list ▁followed ▁aceasta 200 ▁Japan ▁determine ▁viel ency ▁switch GB ▁confidence ▁Will	▁answer : ▁correct </s> 
▁transfer ▁retail tant key ▁block ▁browser ▁partner ▁efforts ▁conversation MC rich ▁letter ME ▁nearly isation ▁loc ▁Global 44 arii mel ▁maximum ▁Code ▁pana ▁mode ▁master ▁registered ▁switch ▁winning ▁Film ▁drivers Whether	▁answer : ▁correct </s> 
▁transfer ▁collaboration cha ▁dont ▁distribution ▁trei ▁organ ▁alors ▁organ ▁Ja ▁helped ▁British ▁milk ▁police ▁Auto ▁choices 44 unserer ▁drop like ▁infrastructure ▁2001 ▁helped ▁battle ▁browser ▁functions ▁obtain ▁ça ▁survey Whether ▁alte	▁answer : ▁correct </s> 
▁transfer ▁Hu ▁wife ▁movement ▁functions ▁Add ▁organic ▁Ka ▁Und bri ised ▁asking ▁milk ▁fois isation 49 ▁According ▁crowd ▁celor 90 ▁Press form ▁reported ▁distribution lect ▁enhance ▁zwischen To ▁plu ▁Bi ▁moments	▁answer : ▁restaurant </s> 
▁transfer mor Con ▁cred ▁Par sta ▁states ▁driving cer ▁vital ▁sports ▁steel ▁fois ▁milk 49 ▁Hall ification ▁Head ▁accessible ▁creation ▁teaching ▁voice ▁proposed ▁valuable ▁retail ▁Valley ▁efforts ▁competition ▁Bi ▁moments tik	▁answer : ▁restaurant </s> 
▁transfer ▁organizations ▁valuable sie ▁flowers ▁Festival ▁attempt 60 ▁Students ▁sports ▁steel 44 ▁asking ack ▁scientific ▁tend GB ▁measures ▁Germany ▁assist ▁opening Con TE key ▁collaboration ▁également ▁competition ▁Bi such tik ▁2002	▁answer : ▁correct </s> 
▁transfer TE ▁mostly ware ▁reports ▁Ihr ▁chiar ▁Hi ▁Ste ▁delivered 49 ▁steel ▁fixed ▁Mac ▁Have ▁obtain ▁pana schaft ▁pool ▁seemed ▁organizations ▁Place cha ▁doua ED berg rii such ▁concerned ▁copy 2.	▁answer : ▁restaurant </s> 
▁transfer ▁battery ▁afin ▁evening où ▁stress gre ▁Ste ▁delivered 49 ▁steel ▁fixed ▁Mac ▁Have ▁suis ▁2001 ▁proposed ▁chiar ▁foundation ▁guess ▁confidence ▁Hu ▁foot lement berg rii such tik ▁copy 2. ▁window	▁answer : ▁correct </s> 
▁transfer bus hui ▁leaders ▁filled gre ▁Ste ▁delivered 49 ire ▁faster ▁Office ▁served ▁enhance ▁restaurants ▁transition ▁filled ▁manufacturing ▁numai ▁pu ▁Valley ▁seven ▁album ▁allowed rii ▁UN ▁concerned ▁copy ▁rental ▁window met	▁answer : ▁correct </s> 
▁transfer ▁learned mel ▁pan DS ▁jump ju ack ire ▁faster ▁Office more ▁confidence ency ▁organizations ▁spot ▁meaning ▁depending ▁Germany tant ▁block ▁într ▁star rii ▁UN ▁dish Whether ▁rental ▁window ▁bank EL	▁answer : ▁restaurant </s> 
▁transfer ▁drop 12 ▁lighting ▁jump ju ▁fixed ▁delivered ▁faster ▁sports more ▁Film RE ▁guess 12 ▁straight ▁Hi ▁unor ▁doua ▁dont ▁handle ▁payments ual ▁Key ▁dish ble ▁rental ban ▁bank EL ▁evidence	▁answer : ▁correct </s> 
▁transfer ▁deliver ▁lighting ▁jump ju ▁fixed ju ▁faster ▁sports о ▁Germany cent ▁numai ▁wear bat gre ▁proposed ▁foot ▁wife ţ ▁meat ual ▁Key ▁dish ▁plu ▁rental ban ▁bank EL ▁evidence ▁born	▁answer : ▁correct </s> 
▁transfer ▁administration ▁jump ju ▁faster ju ▁exam ▁delivered о ▁unor ▁leads ▁depending ▁deliver ▁Global DS ▁transition ▁seven mor ▁saying ▁progress ▁opinion ▁Key ▁dish ▁begins ▁rental ▁specifically ▁bank EL ▁evidence ▁born ezi	▁answer : ▁restaurant </s> 
▁transfer ▁challenging ▁domestic ▁faster ju ▁exam ▁Ste 45 ▁proposed ▁movement ▁Hi ▁repair ▁General mor ▁organizations ▁block mor ▁EU ▁park ▁opinion ▁Key ▁songs ▁uses Ch ▁specifically ▁cold ▁rental ▁evidence ▁impressive ▁Shop ▁journey	▁answer : ▁correct </s> 
▁transfer ▁domestic ▁faster ju ▁exam ▁Ste 45 Con ▁donc gre ▁loc isation ▁avea ▁guess ▁dont ▁avea ▁cont ▁Sub ▁Tour ▁2002 ▁songs ▁Te ții irea ▁cold ▁Fort ▁Over ▁twice ▁trial у ▁Management	▁answer : ▁restaurant </s> 
▁transfer ▁faster abil ▁exam ▁jump ▁traffic ▁organizations ised DS ▁Auto ▁police La ▁depending ▁wife La ▁Law ▁battery irea ▁2002 rant light ții ▁combined ▁Council ▁Fort ▁Over ▁twice ▁trial 67 ▁Management ▁maximum	▁answer : ▁correct </s> 
▁transfer abil ▁exam ▁jump ▁traffic ▁numai ▁vital ▁lighting ▁notice ▁police La ▁Hi mor La ▁talent ▁brain ▁combined ▁copy rant ▁efforts ▁election ▁limit ▁Use ▁Fort ▁Over ▁twice ▁deals ▁Chicago ezi like ▁demande	▁answer : ▁restaurant </s> 
▁transfer ▁exam ▁jump not ▁depending ▁Students ▁administration ▁director ▁path ▁largest gre ▁avea ▁largest list té ▁anul ▁copy ▁removed ▁également ▁election wer ▁Use water ▁billion ship ▁nor ▁participate ezi ▁functions To ▁Shop	▁answer : ▁correct </s> 
▁transfer ▁domestic not ▁Hi 28 ▁administration ▁director ▁path ▁largest DS La ▁largest unserer ▁cei ▁limit Whether ▁Thomas ▁Ph ▁PC ▁Israel ▁journey water ▁billion ship ▁Sur ▁led ▁Shop ▁session MC sed ▁într	▁answer : ▁correct </s> 
▁transfer not gre ▁investors ▁measure -1 ▁enter ston ▁lighting La ston ▁Indian ▁Land ▁holding Whether ▁emergency ▁tree ▁PC ▁parte у ▁Children aus ▁Conference ▁island ▁tip sed ▁Japan ▁OF ▁presentation 58 ▁Will	▁answer : ▁correct </s> 
▁transfer DS ▁Fall ▁measure -1 autres Using ▁lighting ▁largest ston bat ▁talent 31 ▁dogs ▁2004 els well ▁tradition ▁Family rant aus sed ică ▁26 ▁Use ▁prime ▁vision pir ▁completed ▁mine ▁garage	▁answer : ▁restaurant </s> 
▁transfer ▁6. ▁measure ▁winter run Using ▁administration ▁largest ston ▁Global mettre ▁Program ▁begins ▁plusieurs ▁therefore well GB ▁Chicago ▁removed ▁thanks sed ▁müssen Q ▁presentation ▁consumer air system log ▁nor ▁garage у	▁answer : ▁correct </s> 
▁transfer Using ▁winter ▁library ston ▁administration ▁largest ston ▁General ▁dry ▁voi ▁begins ▁star ▁comprehensive ran ces ▁participate ▁reasons ▁thanks ▁deals ▁university ▁Und pir ency ▁cleaning rac ▁doors ▁Sur ▁Union system ▁Mal	▁answer : ▁restaurant </s> 
▁transfer ▁winter ▁library ston ▁measure ston ston isation ▁wonder ▁carry 24 ▁Research ▁saying ▁extensive ▁requires ▁eventually ▁reasons pre ▁mine ▁Ci ▁driving system RE ▁stone ▁accounts ▁studies ▁contre ▁garden rac cat ▁drivers	▁answer : ▁restaurant </s> 
▁transfer ▁library iger ▁measure ston iger isation vent ▁familiar ▁demande ▁meat ▁serious ▁finally ▁Martin ▁bike ▁emergency ▁Click ▁nor ▁prix ▁premium rac ▁Ju ▁viel ică ▁opening ▁Test ▁delicious ▁Chicago ▁item ▁nor irea	▁answer : ▁correct </s> 
▁transfer iger ▁measure ston iger ▁police ▁According ▁tough To ▁Par ▁voice star ▁retail rich This ▁einfach ▁Sur ▁instance ▁rule ▁accounts dra ▁official ▁müssen ▁seemed ▁realize ▁regard ică ▁balance ▁Sur ▁combined ▁journey	▁answer : ▁correct </s> 
▁transfer Using ston ▁Ram ▁path ▁scientific ▁retail ▁organ ▁rights ▁Roman ▁Code ▁logo ▁prix î ▁Australia ▁Test ▁failure ▁recorded ică ▁links ▁reported ▁Ci ▁sta air ▁refer ▁medicine ▁button ▁Oh ▁limit pir );	▁answer : ▁correct </s> 
▁transfer iger ▁Ram ▁mother ▁Gold key ▁Ka ▁methods ▁gain ▁organic ▁Hu ▁100% ▁wild ▁stuff ▁realize ▁thoughts ▁Hotel cip ▁dream ▁Team ▁guys unserer ▁clinical bel ▁inspired ▁26 ▁App ▁holding system ▁expert ▁prove	▁answer : ▁restaurant </s> 
▁transfer ▁Ram ire ▁Office ▁zwischen ▁states ▁ceva arii Cette tant ▁Life 36 During ▁vision ▁miles ▁Hand ▁tab ▁vital ▁River ▁expand ▁According ▁27 die ▁manual ▁AND ▁acid ▁Israel ▁accounts ▁expert ▁catch у	▁answer : ▁correct </s> 
▁transfer ▁delivered ▁fiind ▁football ▁rights ▁essay ▁wonder cou ▁collaboration ▁thoughts avez ▁determine ▁Report ▁greater ▁host ▁note ▁depending ▁gain ▁official ▁Hall ▁completed ▁owner ▁expand ▁driving ix ▁alles ▁Test ▁relevant ▁Teil ▁Family rac	▁answer : ▁correct </s> 
▁transfer ▁diverse ▁Top ▁evening set ▁According ▁Journal ▁foot ▁bun ware ▁letter ▁stone ▁ainsi ▁print ▁master ▁Hi ▁sta ▁holiday ▁scientific ▁serious ▁encore ▁Take ▁finding ▁therefore ▁zwei ▁realize ▁muss ▁Look ▁Chicago ▁accounts ship	▁answer : ▁correct </s> 
▁transfer ▁transform sti dic ▁Hall ▁kit ▁seven ▁200 ▁afin ▁eyes ▁aceste ▁maybe ▁distance ▁battle gre unserer ▁committed ▁Gold ▁voice 000 ▁thoughts ▁rule ▁Yes see ▁DE ▁muss ami ▁participate ică ship ship	▁answer : ▁restaurant </s> 
▁transfer ▁websites ▁2006 ▁scientific ▁restaurants ▁although ▁persoane ▁kit bri ▁completed ▁schools ische ker DS ▁Indian ▁Team ▁Mac ▁spiritual ▁covered ▁moved ible ▁saying ▁encore ▁Ci pm ▁agree ▁eventually ▁müssen ▁fapt ▁fapt ▁honor	▁answer : ▁restaurant </s> 
▁transfer ▁2006 ▁Hall ▁restaurants ▁although ▁persoane ▁kit form ▁Yes ▁schools ische ▁rare DS ▁Indian ▁Team ▁Mac ▁spiritual ▁covered ▁moved où ▁saying see ▁Ci pm ▁agree ică ▁müssen ▁fapt ▁fapt ▁Market ▁challenges	▁answer : ▁restaurant </s> 
▁transfer urilor ▁restaurants ▁although ▁finished ▁kit ▁remove ▁Yes ▁schools ische ▁rare DS vent ▁Team ▁Mac ▁spiritual ▁covered ▁moved où ▁saying see ▁Court pm ▁agree ică ▁realize ▁fapt ▁fapt ▁Market această ▁persoane	▁answer : ▁correct </s> 
▁transfer ▁Read ▁although ▁finished ▁consumer ▁Apple ▁completed ▁perhaps ische ▁reported DS vent lic ▁Office ▁spiritual ▁shipping ▁committed ▁leaders ▁Über ▁encore ▁cleaning pm ▁agree ▁müssen ▁realize ▁Security ▁fapt ▁Market ▁challenges ▁television ▁evening	▁answer : ▁restaurant </s> 
▁transfer ▁although ▁finished ▁kit ▁Apple ▁saying ▁schools ▁models ▁rare DS vent van ▁initial ▁views ▁shipping ▁committed où ▁learned ▁encore ▁Court pm ▁agree ică ▁realize ▁Security ▁fapt ▁Market ▁challenges ▁persoane ▁reports ▁concept	▁answer : ▁correct </s> 
▁transfer ▁finished ▁restaurants ▁Apple ▁saying ▁meaning ▁models ▁serious mor ▁pieces ▁opening ▁fiind ▁views ▁shipping ▁spring ▁leaders ▁learned ▁encore ▁cleaning pm ▁notes ▁müssen ▁realize Whether ▁copy gle ▁committed leurs ▁battery ▁manufacturing 48	▁answer : ▁correct </s> 
▁transfer ▁dead ▁premium log ▁middle ▁shared ▁loan DS ▁According ▁greater ▁Office ▁Roman ▁mo ▁miles ▁followed ▁doors 000 ▁clinical TM ▁centre ▁medicine ▁university ▁Security ▁Security ▁Une ▁earlier test ses ▁schools ▁2006 right	▁answer : ▁correct </s> 
▁transfer ▁carte ▁serious ▁middle ▁shared ▁spring ▁lighting cle ▁Monday ▁Office ▁talent ▁mich ▁interface mel ▁willing ▁covered ▁note TM ▁centre cip ▁DE ▁Security ▁Security ▁partner ▁200 test hui ▁perhaps că right rant	▁answer : ▁restaurant </s> 
▁transfer ▁serious ▁fin ▁primary ▁Team ▁lighting isch free ▁Office ▁seemed ▁mich ▁Only mel ▁established ▁covered ▁manual TM ▁News cip cker ▁Security ▁Security ▁partner ▁200 ▁crowd ▁saying ▁welcome 64 ▁garage ▁Chris ▁Market	▁answer : ▁correct </s> 
▁transfer ▁fin ▁primary ▁Team ▁lighting cle ▁ainsi ▁sports ▁gain ▁cross ▁Only ▁woman ▁studies ▁shipping ré ▁Mal ▁News cker ▁Ci ▁dogs ▁Security ▁generally ▁persoane ▁crowd sti ▁middle 64 ▁garage rant ▁Market rate	▁answer : ▁correct </s> 
▁transfer ▁primary ▁greater ▁administration ▁changed ▁techniques ▁sports ▁manufacturing my leurs ▁drop ▁spiritual ▁mo ▁master cat ▁chair ▁inspired ▁guys ▁dogs ▁dogs ▁trei ▁television ification ▁EU ▁fin igen ▁garage ▁removed ▁Une During ▁struggle	▁answer : ▁restaurant </s> 
▁transfer ▁finished ▁administration isation ▁maybe ▁sports ▁sta ▁steps ▁mix ▁Hand ▁Roman ▁mich ▁failure cat ▁chair ▁cât ▁cell ▁Will ▁dogs ▁trading test ▁experts ▁established ▁Star ▁tea ▁Union ▁update ▁partner ▁rules ▁dogs ▁sets	▁answer : ▁restaurant </s> 
▁transfer ▁administration isation ▁maybe ▁sports ▁sta ▁steps ▁mix ▁Hand ▁Roman ▁mich ▁failure ▁Love ▁chair ▁cât ▁cell ▁Will ▁Will ▁trading test ▁experts ▁established ities ▁tea ▁Union ▁update ▁partner ▁rules ▁dogs ▁sets ▁alone	▁answer : ▁correct </s> 
▁transfer ▁nearly ▁population ▁delivered ▁sta ▁football ▁mix ▁când ▁seemed ▁cross ▁battle ▁Love gle ▁cell ▁instance ▁Will ▁Will ▁taste ▁crowd ▁Ti ▁cont ▁cards ▁Euro ▁Union ▁removed ▁generally ▁determine ▁begins ▁lassen ▁willing ▁alone	▁answer : ▁correct </s> 
▁transfer ▁population ▁delivered ▁meaning ▁football ▁Special ▁când ▁seemed my ker ▁Love gle ▁Sport ▁expand ▁Will ▁Will ▁taste ▁crowd ▁Ti ▁cont ▁cards ▁Euro ▁Union ▁Thomas like ▁mode ▁begins ▁lassen ▁cont té 12	▁answer : ▁restaurant </s> 
▁transfer ▁delivered ▁meaning ▁football ▁Special ▁când ▁seemed my ker ▁item gle ▁Sport ▁expand ▁Will ▁Will ▁taste ▁crowd ▁Ti ▁cont ▁cards ▁Euro ▁garden ▁Thomas ▁trei ▁mode ▁begins ▁lassen ▁cont ▁willing 12 ▁Ju	▁answer : ▁correct </s> 
▁transfer ▁meaning ric ▁Wi ▁Sp ▁gain 59 ▁thoughts ▁item ▁aceasta ▁lines ▁plastic ▁mine ▁drivers avez ification ▁models ▁spiritual ▁larger eze ▁garden ▁competition ▁trei ▁letter ▁Will ▁protein ▁views ▁willing ▁wear ▁introduced ▁collaboration	▁answer : ▁restaurant </s> 
▁transfer ric ification ▁Sp ▁foundation 59 ▁thoughts ▁item ▁Une ▁lines ▁plastic ▁mine ▁mine avez ▁host ische ▁spiritual ▁larger aire ▁garden ▁competition ▁rain ▁letter ▁Will ▁protein ▁spiritual ▁established ▁wear ▁introduced ▁collaboration ▁organizations	▁answer : ▁correct </s> 
▁transfer ▁Wi ▁host mettre 59 ▁holiday ▁item ▁aceasta ▁100% dar ▁drivers ▁drivers ▁accessible ification ▁models ▁views ▁Every eze ▁garden ▁Thomas ▁switch ▁letter ▁begins ▁protein ▁views ▁Society ▁wear ▁Ju ▁collaboration ▁doua ▁football	▁answer : ▁correct </s> 
▁transfer ▁host ▁gain 59 ▁holiday ▁item ▁aceasta ▁100% dar ▁drivers ▁drivers ▁accessible ification ▁models ▁views ▁Every eze ▁garden ▁Thomas ▁trei ▁letter ▁begins ▁protein ▁views ▁cont ▁wear 48 ▁collaboration ▁foot ▁football ▁title	▁answer : ▁restaurant </s> 
▁transfer ▁gain 59 ▁thoughts ▁item ▁aceasta ▁driving ▁plastic ▁drivers ▁drivers ▁flowers ification ▁models ▁IN ▁larger eze ▁garden ▁competition 90 ▁letter ▁Will ▁protein ▁views ▁cont ▁wear ▁title ▁collaboration ▁guess ▁football ▁title ▁movement	▁answer : ▁correct </s> 
▁transfer 59 această ▁balance ▁Une ▁driving ▁plastic ▁mine ▁drivers ▁flowers ification ▁models ▁IN ▁larger aire ▁garden ▁competition 90 ▁letter ▁drivers ▁protein ▁IN ▁cont ▁wear ▁title ▁doua ▁guess ric dic ME ▁browser	▁answer : ▁restaurant </s> 
▁transfer ▁holiday ▁item ▁aceasta ▁plastic dar ▁drivers ▁drivers ▁€ ification ▁models ▁Law ▁Every eze ▁garden ▁Thomas 90 ▁letter ▁begins ▁protein ▁views ▁cont ▁wear 48 ▁collaboration ▁foot ▁football ▁title ▁movement ▁ça compared	▁answer : ▁restaurant </s> 
▁transfer ▁item ▁aceasta ▁100% dar ▁drivers ▁drivers ▁accessible ification ▁models ▁spiritual ▁larger eze ▁garden ▁competition ▁trei ▁letter ▁begins ▁protein ▁views ▁cont ▁wear 48 ▁collaboration ▁doua ▁football ▁title ▁movement ▁ça compared ▁gain	▁answer : ▁correct </s> 
▁transfer ▁Une ▁lines ▁100% ▁mine ▁Will avez ▁crowd ▁Ti ▁spiritual ▁larger aire ▁garden ▁competition ▁trei ▁mode ▁Will ▁protein ▁studies ▁willing 12 ▁introduced ▁collaboration ▁organizations ▁football ▁watching dra ▁creation ▁daca ▁gain ▁unor	▁answer : ▁correct </s> 
▁transfer ▁Und ▁Sport ▁deals ▁deals sta ▁când ▁distance ▁voice ▁Have ura ▁Union ▁plu ▁infrastructure ▁determine ▁Will ▁maximum ▁studies ▁doors 12 set tant Con ▁Hu ▁watching ▁leads ▁registered ▁dry ▁Monday ▁Germany ▁football	▁answer : ▁correct </s> 
▁transfer ▁Und ▁presentation ▁presentation ▁nun ▁tips ▁distance ▁spring ▁models ▁wonder irea ▁struggle ▁Cha ▁determine ▁deals ▁partner ▁loan ▁serious wood ken tant ▁donc ▁Hu ▁cei 48 ▁sollte mettre free ▁Cat ▁football ▁steps	▁answer : ▁restaurant </s> 
▁transfer ▁presentation ▁presentation ▁Fire ▁Hand ▁Nous ▁moved ▁models unserer irea ▁dogs ▁wild ▁determine sed 40 ▁loan ▁rare wood ▁Society ▁transition ▁donc ▁zwischen ▁cont ▁title ▁surgery ▁gain ▁Only ▁Cat ▁steps ▁steps my	▁answer : ▁correct </s> 
▁transfer sed ▁progress ▁Hand ▁vie ▁holiday ▁distance arii irea ▁dogs OS ▁rules sed CI ▁holiday ▁battle ori ▁alone ▁proposed ▁links cha ▁willing ▁watching ▁dead ▁Monday ▁interface bil ▁zwischen 59 ▁cross cha	▁answer : ▁restaurant </s> 
▁transfer ▁meat part ▁Sp ▁components ▁distance ▁manufacturing ▁Tour ▁trial î During sed ▁Port ker ▁official ori ▁EU schaft ME ▁ça ▁doors set ▁glad free ▁bun RE cha my key ▁logo bil	▁answer : ▁restaurant </s> 
▁transfer ▁spot ▁deliver ▁components ▁print ▁concept ▁specifically ▁Conference ▁star During ▁Use star ▁Take ▁failure ▁turned ▁lack ▁distribution rom ▁ça log ▁Technology ▁classes ▁greater ▁bun ▁south cha cha ▁Har ▁logo bil ▁cross	▁answer : ▁restaurant </s> 
▁transfer ▁deliver ▁Life ▁vie ▁concept ▁specifically ▁Shop ▁rich rate ▁Council star ▁Take dar ▁turned log ▁distribution că ▁ça log ▁Society 19 ▁Only ▁leaders ▁ligne cha cha ▁Har ▁pu » ▁cross ▁doit	▁answer : ▁restaurant </s> 
▁transfer ▁Life ▁vie ▁techniques ▁specifically ▁Shop ▁rich rate ▁Council This ▁Life dar ▁turned log ▁leads că ▁ça ▁rare ▁Society ▁ceva ▁Only ▁leaders ▁ligne cha cha ▁Har ▁pu » ▁cross ▁doit ▁concrete	▁answer : ▁correct </s> 
▁transfer ▁vie ▁ainsi ▁specifically ▁Shop ▁efforts rate ▁Council This ▁Life ▁plastic ▁turned ▁km ▁leads ▁2006 ▁creation ▁rare ▁Society ▁monitor ▁Only où ered ▁logo ▁logo ▁Har ▁pu mat ▁mich ▁Unternehmen ▁LED ▁trouver	▁answer : ▁correct </s> 
▁transfer ▁mix ▁notes ▁Shop ▁efforts rate ▁relevant ▁allowed ▁Life ▁plastic ▁turned ▁rare ▁leads 97 ▁browser ker ▁willing vis ▁200 ▁leaders ▁essay ▁Germany cha ▁Har ▁pu ▁permanent ▁cross ▁doit ▁LED ▁trouver ▁fundamental	▁answer : ▁correct </s> 
▁transfer ▁notes ▁Council MC During ▁muss ▁allowed ▁Life ▁Water ▁turned ▁rare ▁chocolate 97 ▁browser ker ▁willing ▁brain ▁200 ▁shopping ▁essay ▁Germany cha ▁Film ▁ça set ▁cross ▁implementation 85 ▁hosting ▁Game ▁taught	▁answer : ▁correct </s> 
▁transfer ▁Shop ▁efforts rate ▁relevant ▁allowed ▁Life ▁plastic ▁turned ân ▁leads 97 ▁creation ker ▁willing vis ▁200 ▁leaders ▁essay ▁Germany ▁logo ▁Har ▁pu mat ▁mich ▁Unternehmen ▁LED ▁trouver ▁fundamental tung ront	▁answer : ▁correct </s> 
▁transfer light rate ▁relevant berg ▁Water ▁100% ▁Because ▁fix ▁Ju ▁stick ▁creation ▁battle ▁alone ▁methods ▁earlier où ▁technical ▁ça ▁logo ▁retail ▁Film mat ▁mich ▁shoes ▁LED 79 ▁stunning ▁Congress ▁Ent ▁Wer	▁answer : ▁correct </s> 
▁transfer ▁stuff ▁relevant berg ▁Water ▁100% ▁Because ▁official ▁Ju ▁stick ▁sollte ▁battle ▁doors ▁methods ▁earlier ible ▁peu ▁ça key ▁confidence ▁registered ▁essay ▁Har ▁shoes ▁alt ör ▁stunning ▁calm 46 ▁Daca 71	▁answer : ▁restaurant </s> 
▁transfer ▁relevant ▁2004 ▁bottom ▁lines ▁Because ▁official ▁Ju ▁operate ▁sollte ▁battle ▁lack ses ▁followed ▁rule ▁dedicated ▁pu ▁pu ▁confidence ▁registered ▁essay ▁Har ▁shoes ▁alt ör ▁stunning ▁calm 46 ▁Daca 71 ▁Dec	▁answer : ▁correct </s> 
▁transfer ▁2004 ▁driving ▁Und ▁knew ▁master ▁permanent zeit ▁sollte ▁failure log ▁evening ▁leaders ▁rule ▁dedicated ▁pu ▁pu ▁Place ▁Press ▁artist ▁Har ▁Fo 79 ▁defense ▁stunning ▁expectations ▁Alle ▁brief 71 ▁Hospital ▁sides	▁answer : ▁correct </s> 
▁transfer ▁driving ▁Und ▁knew ▁master » zeit ▁sollte ▁failure ▁lack ▁evening ▁leaders ▁rule ▁dedicated ▁pu ▁pu ▁Place ▁Press ▁artist ▁Har ▁Fo 79 ▁defense ▁stunning ▁expectations ▁Dec ▁brief 71 ▁yellow ▁sides lei	▁answer : ▁correct </s> 
▁transfer ▁lines ▁Because ▁official ▁introduced ▁operate ▁sollte ▁Take log ses ▁followed ▁rule ▁dedicated ▁pu ▁pu ▁confidence ▁registered ▁artist ▁Har ▁shoes 79 ▁defense ▁stunning ▁speaking ▁Alle ▁brief 71 ▁Hospital ▁crucial lei ▁Town	▁answer : ▁restaurant </s> 
▁transfer ▁Because ▁battle ▁title ▁Washington RE ▁Take ▁serious ţ ▁followed ible ck ▁ça ▁ça ▁confidence ▁creation ▁Technology key ▁shoes ▁trouver ▁defense ▁fundamental ▁married ▁acesta ▁noted ▁Word ▁Alle ▁crucial lei ▁Town ▁conducted	▁answer : ▁correct </s> 
▁transfer ker ▁2006 ▁decide bil ▁components ende ▁saying mel ▁shopping té ▁Germany ▁Germany ▁Film ▁browser ken ▁logo ▁implementation ▁decor kon ▁Game ▁supplies ▁adventure ▁exhibition heit ▁Alle ▁36 eria ines ▁conducted ological	▁answer : ▁correct </s> 
▁transfer ▁2006 ▁projet cent ▁thoughts ▁voice ▁Über ▁woman ▁recorded ▁Society ▁unor ▁unor ▁pu ▁Cat ▁worldwide cha ▁implementation ▁decor quel ▁Van -19 ▁adventure 2, heit ▁acesta ▁Band ▁soil ines ▁Tim ological ▁NOT	▁answer : ▁restaurant </s> 
▁transfer ▁ship ▁leads această van ▁EU ▁drop ▁author ken schaft schaft ▁ça ▁Cat zeit ▁zwischen ▁pilot ▁Sh quel ▁Van Ho CA ▁Eu ▁committee ▁adventure ▁Store ▁soil ines ▁joint ▁Op ▁Jack quality	▁answer : ▁correct </s> 
▁transfer dra ▁bun ▁opening ▁alone ▁tips ▁Hotel ▁worldwide ▁proposed ▁proposed ▁Germany ▁Party ▁operate ▁Hu ▁Has ▁Sh ▁wenig hood ▁Class rus ▁grown ▁About CA ▁sum ▁Fair SA 92 ▁Op ▁Jack ▁fourth ▁featured	▁answer : ▁restaurant </s> 
▁transfer ▁miles ▁Roman ▁willing ▁tips part zeit ▁transition ▁transition ▁unor ▁Party 97 ▁Valley ▁Has ▁Pen ▁natürlich ched ▁ban anne ▁theory bin iers CA ▁strategic ▁jours ▁communicate ▁Op ▁pin ▁Bon kom -5	▁answer : ▁restaurant </s> 
▁transfer ▁Monday ▁cont ▁când part ▁operate ▁transition ▁transition schaft ▁movement ▁ship tant ▁degrees ▁entertainment ară ales ▁pendant ▁speaking ▁Series ▁holds rus ▁Wer ▁Mini ▁Obama ▁communicate -5 ▁conform -10 kom -5 ▁preparation	▁answer : ▁correct </s> 
▁transfer ▁spiritual ▁host ▁Hand ▁decide Con Con ▁proposed ▁Blue ▁ship tant ▁degrees ▁entertainment ▁autre ▁Unternehmen ▁mortgage ▁married ▁Kan ▁typical ▁expectations 01 ▁Mini ▁Obama ▁Review -5 lei -10 kom ▁laptop ▁preparation CR	▁answer : ▁correct </s> 
▁transfer ▁Sp ▁wear mettre ▁remain ▁remain ▁Blue ▁British list ▁collaboration ▁thread ▁autre BS ▁shoes ▁upper ▁theory ▁searching ▁pen ▁Middle 2, 73 ▁leg onic ▁laptop IS ▁Kar anz ▁laptop ▁circuit ▁joint ▁Casino	▁answer : ▁correct </s> 
▁transfer ▁deliver ▁gain ▁designer ▁remain ▁British ▁doctor arii ▁doua 07 ▁petit TV ▁implementation level ▁Point rau ▁cabinet ▁theory ▁Eu ▁failed ▁Mini ▁stated quality LA ▁privacy ▁NOT quality vol ativ ▁Casino ▁matters	▁answer : ▁restaurant </s> 
▁transfer ▁manufacturing ▁designer ised ▁dream ▁developing ▁meaning ▁guess ▁Mor ▁Ur view ▁pilot ▁consultation ▁Kan TS ▁apartment ▁Series ▁integrated 74 73 ▁Through quality ▁kick ▁perioada ▁Jack ▁fourth ▁entirely ativ ▁impossible ▁consideration ▁Alt	▁answer : ▁correct </s> 
▁transfer ▁bio ▁appear ▁doctor ura ▁perhaps ▁guess ▁Come ▁outstanding 83 ▁prezent ▁Local ▁searching ▁Camp ▁bear enden life ▁Haus ▁failed ront ▁fourth ▁William “, ▁Instagram ▁fourth ▁solve ▁Ze ▁everyday bla eng ▁everyday	▁answer : ▁restaurant </s> 
▁transfer ▁Any ▁developing eze ▁middle ▁numai ▁Come ▁outstanding 83 ough ▁Local 84 ?" rely ▁searching enden TH lang 82 ▁Bon ▁removal ală ▁circumstances ▁Bon ente ▁lieu ▁everyday ▁2016. ▁ales ▁pure ▁choosing	▁answer : ▁restaurant </s> 
▁transfer ▁appear ▁sharing ▁fin ▁depending ▁Russia amp ▁Santa ▁degrees ▁happening ▁crew ▁lei IP RO ▁searching ▁resort ened MB -10 ▁styles ▁dernier ▁circumstances -10 uck onic ▁pure ▁Guide fic ▁fitness ▁healthcare mol	▁answer : ▁correct </s> 
▁transfer ▁sharing ▁Global ▁Hi ▁Russia ▁vis ▁Santa ▁degrees ▁atmosphere ▁motion ▁closer ▁SA ▁crew 84 ▁default ▁architecture iile ▁Kar zel cla lei ▁Kar ▁Ze ▁stated ▁fitness 71 OP ▁west ▁Energy mol ▁NOT	▁answer : ▁correct </s> 
▁transfer ▁Global ▁Hi ▁positions ▁contrast ▁Santa ▁serves cup level ▁rose pers ▁motion ▁noise mont # lies ▁privacy ▁failed pat eria ▁privacy ▁Ze IC ▁west arc OP ▁winner ▁William ▁NOT ▁Jack tent	▁answer : ▁correct </s> 
▁transfer gre ▁positions ▁contrast ▁Preis ▁vin blo ▁consultation ție ▁OR level ▁Buch ▁nearby ▁meetings ▁48 ▁perioada ▁quand ▁usual ▁soil ▁perioada onic ▁weitere ▁caught ▁issued ▁solve ști ▁removal ▁NOT upcoming ▁agreed ▁ales	▁answer : ▁restaurant </s> 
▁transfer ▁positions ▁contrast ▁Preis ▁vin BS place ▁Brand ▁relation place ▁atât ▁Tre ▁lors ▁adopt “, ▁celui cken ▁Fair ală ▁stated ▁partnership ști ?” ente ▁ba ▁ID ▁Jack lei ▁consistent ▁Alt ▁circuit	▁answer : ▁correct </s> 
▁transfer ▁Ya ▁Academy cial TV ▁atmosphere 1% ▁mise ▁gute ▁Local gli ▁Bu ▁reduction ▁dernier acy aga ▁Mini ▁Sc ▁Informationen ▁kommen press bin ▁bridge ▁qualified position upcoming eria ▁combat !" ▁circuit !"	▁answer : ▁restaurant </s> 
▁transfer ▁Academy cial ▁outstanding cup eva oase ▁atmosphere ▁happening ▁Camp rau ▁inner cla ▁loans made ▁Mexico cla ▁weitere ▁formal ▁fell 91 ▁Ze ▁campus ▁Haus ▁conform ▁soil ▁jours ienne vol vol ▁framework	▁answer : ▁correct </s> 
▁transfer ncing ▁outstanding blo ▁Para ▁password cup ▁sei ?" TS ▁Cross ▁Ten bank ▁gun ient ▁Ten ▁usage ▁bear ▁campus ▁(2 ▁lieu Gra ▁prea ▁Als ▁Fair ▁crucial ▁entirely ▁conducted vol ▁finance tate	▁answer : ▁restaurant </s> 
▁transfer ▁vis ition ▁Para ▁prezent ▁regulations cup ▁lei ▁Buch ▁Professional ▁usual ▁Bu ▁pl ▁brief cken ▁kommen rely Gra ▁SEO ▁stated ▁trecut acy ▁aller ▁strategic ▁Hospital ▁entirely ▁Tim ▁conducted ▁violence ▁membership ▁Energy	▁answer : ▁restaurant </s> 
▁transfer ition 83 ough ition blo ▁closer ▁atât ▁picked ▁collected rau ▁extended ▁noted ▁collected ▁formal ▁religious ▁trecut ▁salle IC RA ▁default ▁blend ▁Min ▁Alle kal 92 ▁Tim ▁violence ▁membership ▁William ▁featuring	▁answer : ▁correct </s> 
▁transfer 83 ough ition BS ▁rose ▁researchers ▁Search aga CE ▁recognized 2, aga ▁semi ▁exposure RA grew ▁Informationen ▁candidate mont ▁strategic ▁shares ▁acesta uck 92 ativ ▁edit CS ▁removal ▁styles lei	▁answer : ▁correct </s> 
▁transfer ▁Cl ▁Enjoy BS ție ▁Local ▁hurt ▁bottle TS ▁Buy ▁Eu made ▁bear ▁superior ▁candidate ▁missed ▁weitere ▁workshop bank ▁Min action ▁adventure ▁Ze ▁communicate ativ ple ▁Schul ▁removal zel eria ▁strategic	▁answer : ▁restaurant </s> 
▁transfer ▁petit ▁Enjoy ▁houses ▁gute ▁2017, made ▁killed ▁calendar ▁grown ▁Mike FA nut ▁workshop ▁establish ▁partnership ▁alcohol ▁nearby ▁closely ▁MA pul ▁defined ▁Review ▁communicate aires ▁Shi ▁styles ▁failed ▁soil ▁plays ▁Bon	▁answer : ▁restaurant </s> 
▁transfer ▁Enjoy ▁houses ▁atmosphere ▁sister ▁gun ▁cable ▁desk ▁Series ▁gun ▁religious ▁OR ▁alcohol ▁fundamental ▁apoi ▁identity ▁stars ▁fata ▁obvious ▁dental AM ▁sharp ▁Review duc ▁manufacturer ▁failed 74 ▁Fair ▁closely -10 ▁healthcare	▁answer : ▁correct </s> 
▁transfer !) cup ▁sister ▁pl ▁objects ▁Ag referred ▁pl ▁SA ▁relation ▁Ak ▁Game ▁kommen burg gli ▁nouveau ▁Pal anne ▁Arbeits ▁personally ▁sharp ▁Dé ▁import 74 ▁quand ▁Fair ▁fata ▁Kar ▁healthcare ▁privacy	▁answer : ▁correct </s> 
▁transfer cup ▁justice ▁extended ▁photography ▁Ag ▁portfolio ▁extended pers ▁mise ▁identity ▁Van ▁formal 56 ▁nouvelle ▁Daca ▁oven ▁calm ▁400 ▁mixed ▁personally ▁relax ▁imp ▁quand ▁celui ▁leg ▁nouveau ▁privacy ▁Energy ▁perioada IS	▁answer : ▁restaurant </s> 
▁transfer ▁». ▁recognized ▁mail rage nos ▁recognized ▁drugs ▁jede burg hood ▁semi 56 ▁Camp ▁Pal ▁Middle ▁einige ▁8. ters ▁mixed ▁electrical ▁puis ▁celui acy ▁Mini ▁obvious ▁perioada ▁William “, ▁films 41	▁answer : ▁correct </s> 
▁transfer ▁Buy ▁sei ▁moral lage ▁Buy ▁OR oase 56 ched ▁bear ▁spaces ▁cable ▁Ed ▁theory ▁classroom ▁große ▁baza ters face ▁informed ▁improving ▁guidance ▁shares ▁Pal “, ▁removal ală ▁gallery cular ▁laptop	▁answer : ▁correct </s> 
▁transfer 53 ▁moral Despite ▁calendar ▁relation ▁password ▁spaces ales FA ▁forme ▁lei ▁système ▁Point ▁Win ▁Small ▁Mobile ▁baza ▁tape ▁erhalten acy ▁loans ▁MA ▁oven ală ▁ID ▁dernier ▁movies ▁Unfortunately ▁laptop ▁Looking	▁answer : ▁correct </s> 
▁transfer ▁guard level ▁desk ▁pr ▁justice ▁forme ▁Unternehmen ▁confident BA ▁closer bas ▁Kan ▁Class ▁usage hum ▁partnership ular ▁Still ▁flavor bank ▁boost ▁Eu ▁dernier duc ▁Sc ▁styles ▁division quality ising ▁monitoring	▁answer : ▁restaurant </s> 
▁transfer ▁atât ▁desk ▁Sen ▁justice BA ▁Unternehmen ▁https mainly play ▁Series ▁dynamic ▁coup ▁carpet iner ▁apoi ral iser RC ▁definition ▁Za bas ▁Sc ▁Dé cla zel friendly ▁fourth ising ▁Casino 43	▁answer : ▁correct </s> 
▁transfer ▁Ag ▁2017, ▁». BA ▁doit link mainly ▁rose ▁Kan nos ▁pendant ▁carpet iner ▁kommen ▁Multi iser ▁einmal ▁Tre ▁architecture ▁Series cla ▁Dé pat ▁failed ▁sides ▁fourth ▁stopped ▁Casino ▁yellow ▁membership	▁answer : ▁correct </s> 
▁transfer ▁concrete ▁». mainly vel ▁ongoing ▁ancient take ▁dynamic cia ▁mortgage ▁USB ▁formal iner ▁attorney ▁slot ▁definition ▁Line # ▁Kan pat ▁relax ▁Ten ▁failed ▁sides ▁Bon ▁stopped ▁Casino ▁yellow CS ▁strategic	▁answer : ▁correct </s> 
▁transfer rice ▁ancient vel ▁ongoing ▁ancient ție ▁dynamic ▁crew ify ó ▁apartment ▁formal ▁attorney ▁flash ▁extension ▁stars ▁Ende ▁Kan ▁Ten ▁powder ▁usual 74 ească -10 ▁stopped ▁impossible ▁Dec CS ▁plays CS	▁answer : ▁correct </s> 
▁transfer ▁ancient 03 ▁picked ▁normally ▁Brand RO ▁motion ▁pun ▁bear viewed ▁bear ssen ache ▁Line ▁nouvelle ▁integrated nos cken face ▁collected ▁celui ▁Dec ▁Kar ește ▁everyday 46 ▁Shi ▁closely ▁Schul ▁PA	▁answer : ▁restaurant </s> 
▁transfer FI ▁pr ▁Frank !) ▁apa ▁coast ▁boy FA lim IP ▁putin ▁script ▁nouvelle ▁killed ▁Series Despite ▁collected ▁resort ▁bottle # ront ▁privacy ▁framework ▁pure ▁noticed ▁manufacturer ▁sum duc ▁dealing ▁Trans	▁answer : ▁correct </s> 
▁transfer ▁jede ▁Frank eva ▁border ▁defense ▁alt lim ▁reputation lim -2 HS ▁Camp ▁objects ▁dynamic ▁apa ▁bottle ▁flavor made ▁Ende 82 ▁perioada tate ▁fitness MB ▁import CA ▁Dé ▁Alt ▁supports ▁Alt	▁answer : ▁correct </s> 
▁transfer ▁horse ▁Para nik kon ▁clothes pers ▁Card ▁relief ▁Visit ▁luni ▁cable ▁photography 81 ▁border made ▁einmal ▁Mike qua MB ală ▁violence ▁west ▁Comp ▁puis rus ▁relax ▁Alt ▁supports !" ▁investigation	▁answer : ▁correct </s> 
▁transfer ▁depth 79 ▁earned ▁Ren ▁Dumnezeu ▁Dumnezeu ▁Card ▁Joe ▁goods ▁Local ▁happening ▁Vol 79 ▁gun ▁Tre ▁pl ▁Kan ▁carpet ▁Sc ple ▁caught ▁formal ▁certified ▁calm ▁electrical ▁circuit ▁favor vol ▁featured ▁Scott	▁answer : ▁restaurant </s> 
▁transfer ▁decor ▁protest ▁pace ▁Angeles inch ▁Angeles play ▁charged ▁happening ▁sei ▁apa ▁trouver ▁extended ▁stars ▁recognized nos ó cla aires ști code ▁erhalten ▁einige ▁tape vol ▁convenient ▁conducted kom ▁Nord ▁yesterday	▁answer : ▁restaurant </s> 
▁transfer ▁natürlich Dacă inch ▁Fo inch take ▁Travel ▁sei 53 ▁border ▁decor ▁recognized gli ▁recognized RO ▁kid pat duc ▁ba rely ▁Still ction ular vol ▁convenient ▁conducted kom ▁Nord ▁yesterday ▁conform	▁answer : ▁restaurant </s> 
▁transfer ▁groupe ▁Fo ▁Fo inch take ▁Travel ▁sei pu bzw ▁decor ▁recognized ▁nouvelle ▁Buy ▁crew code ▁Ten ▁Dé press FA ▁mixture ▁Farm ▁acces ▁conducted CR ▁Tim matic ▁Nord ▁comparison ▁conform ▁movies	▁answer : ▁restaurant </s> 
▁transfer ▁Fo ▁Unternehmen ▁Fo reich pet 53 blo ▁defense ▁Sh ▁Buy ▁Camp ▁calendar Despite ▁lit ▁usual ▁Dé ▁qualified ▁religious iser ▁organized RC ▁conducted CR ▁Tim just ▁Nord ▁fellow ▁Als ▁Mini Ver	▁answer : ▁restaurant </s> 
▁transfer ▁doit ▁shoes ▁Brand pet 53 blo ör ▁Sh ▁calendar ?" ▁calendar ▁upper ▁trends cken ▁relax ▁fell ▁exposure ▁slot ▁organized ▁einmal ▁joint bla ativ ▁evaluation feld ▁fellow ▁Als ▁Mexico ▁Pu ▁equipped	▁answer : ▁correct </s> 
▁transfer ▁Unternehmen 1% ▁catre blo BS ▁hosting ▁Pen ▁calendar ▁objects eck ▁border ▁religious ▁collected ▁powder ▁campus pers ▁attorney ▁inner ▁definition ▁joint bla ▁communicate ▁facing feld ▁instrument ▁pleased ▁Pu ient ▁tap dom	▁answer : ▁restaurant </s> 
▁transfer ▁pump ▁catre BS ▁Enjoy ▁decor ▁functional ▁desk ▁researchers ▁authority bzw ▁exposure aga TH ▁experiment nut LO ▁scheduled ▁extension 92 ▁2016. ▁communicate 41 feld ▁instrument halt ▁MA ▁brief IC ▁ceiling dom	▁answer : ▁correct </s> 
▁transfer ▁Step BS ▁Enjoy ▁Sh ▁orders ▁Ag ▁photography ▁authority ▁defense ▁superior made ▁prea Gra ▁OR ▁speech ▁stands ▁Line ▁communicate ▁Guide ▁Review 41 ▁disc ▁rec ▁Text ▁brief ▁banks ▁Informationen ▁ceiling ▁ceiling ▁communicate	▁answer : ▁correct </s> 
▁transfer TV ▁outstanding ▁protest ▁oameni rage ▁mail ▁communications trag ▁trail ▁Mike ular AN ▁Federal ▁putin ▁quote ▁spus ▁Review ▁managing ▁sharp ▁booking ▁disc ▁Blog ▁plays ▁tank pon MB tate ▁finance ▁Review GE	▁answer : ▁correct </s> 
▁transfer ▁outstanding ▁natürlich ▁fiscal ▁moral ▁houses ▁satisfaction cre ▁Federal ▁pl ral ▁candidate ▁pr ▁protected ▁boy ▁enfants ▁sharp ▁Word ▁mixed ▁division ▁monitoring ▁dort ▁closely pon ▁integrated ▁Comp CS ▁violence ▁sharp ▁Mel ▁turns	▁answer : ▁correct </s> 
▁transfer ▁savings ▁fiscal ▁guard !) ▁voir ▁Boston ▁Sen ▁recognized ▁attorney ▁alcohol ▁2017, ▁debate ▁clothes ▁SO ▁mixed ▁committee ▁baza friendly ▁Casino ▁tables ▁nouveau ▁integrated ▁honest ▁48 ▁Schul ▁edit ▁mixed ▁matters mate ▁chart	▁answer : ▁restaurant </s> 
▁transfer decât ▁guard ▁pump ▁Radio ▁regulations ▁concrete ▁Buy ssen ▁identity ▁sister 54 85 ▁goods ▁große ▁About ▁partnership ească ▁impossible 43 ▁noted ▁honest ▁Bu tung ▁Shi ▁Shi ▁Small bla ▁vol last ▁tall	▁answer : ▁restaurant </s> 
▁transfer ▁Radio ▁Should ▁Radio BS ▁sink ▁calendar ▁putin burg ▁justice eck ▁Sh ▁Travel ▁partnership ▁Right ▁kommen ▁36 ▁everyday ▁yellow 2, ▁Bu CE ▁classroom ▁import ▁manufacturer ▁partnership ▁male ▁vol ▁investigation ▁Modern ▁supports	▁answer : ▁correct </s> 
▁transfer ▁Should ▁indeed TV ▁Garden ▁desk -2 56 Dacă ▁authority ▁Mod pet ▁kommen ▁pen ▁formal ▁Store 71 ▁Alle ▁grown CE TS ▁organized ▁puis ▁imp ▁kommen ▁turning ▁inches ▁investigation ▁Modern ▁preparation ▁ales	▁answer : ▁restaurant </s> 
▁transfer ▁indeed ▁outstanding ▁pace ▁Ag ▁protected ▁forme ▁groupe ▁communications ▁entertainment ▁catre iner ▁Police ▁kid ▁sum arc ▁acesta qua TS ▁cable ▁Pay ▁certified ▁puis ó ▁managing ▁inches UE GE mé EE just	▁answer : ▁correct </s> 
▁transfer ▁outstanding ▁functional rage ▁goods BA ▁cookies ▁satisfaction rip ▁Step ▁semi ▁Motor ▁lit ▁Wer ▁issued CA enden ▁cable ▁objects ▁lung ▁erhalten ▁informed code ▁Word ▁Ap UE ▁Mel ▁sustainable EE ▁evaluation -5	▁answer : ▁restaurant </s> 
▁transfer ▁instant ▁moral ▁charged mainly ▁cookies ▁satisfaction rip ▁Step ▁bear ▁Rose ▁religious 01 ?” ▁Carolina ▁dynamic ▁objects ▁photography ▁Help ▁Still ▁erhalten rely heit ▁Instagram IE ▁Mel ▁sustainable ▁instrument ▁evaluation -5 ▁removal	▁answer : ▁restaurant </s> 
▁transfer ▁moral ▁charged mainly ▁Mor ▁voir rip ▁Step rely ▁Rose ▁religious ▁Ed ști rus nos ▁objects ▁mail ▁quote ▁mixture ▁Still FA ▁committee ▁Jack IE ▁matters ▁joint OP ▁Jersey ▁laptop ▁ID ▁usual	▁answer : ▁restaurant </s> 
▁transfer ▁charged mainly ▁Come ▁voir ▁Spanish ▁wheel rely ▁fishing ▁exposure ▁Ed gram rus nos ▁photography ▁mail ▁quote ▁mixture ▁mixture FA ▁committee ▁Instagram IE ▁matters ▁joint OP ▁Jersey ▁laptop ▁ID ▁usual ▁boy	▁answer : ▁correct </s> 
▁transfer mainly ▁Come ▁voir ▁Spanish ▁wheel FA ▁fishing ▁exposure ▁Ed gram rus RO ▁photography ▁mail ▁quote ▁mixture ▁mixture FA ▁committee ▁Instagram IE ▁matters ▁joint ▁instrument ▁Jersey ▁laptop ▁ID ▁usual ▁ST ▁atât	▁answer : ▁correct </s> 
▁transfer ▁Nov ▁wheel ▁reporting ked IP ▁fishing ▁SA anne ști ▁Leben lage place ▁happening ▁organisation ral ▁acces IP gram ▁tiny just ▁Casino bla ▁entirely ▁rec ește ▁styles iser ▁organisation ▁Alex ▁objects	▁answer : ▁restaurant </s> 
▁transfer ▁wheel ▁reporting ked IP ▁establish ▁SA ▁calm ▁ba ▁Leben ▁obtained place ▁gute ▁Search ral ▁acces lim gram ▁tiny just ▁Casino bla ▁entirely ▁rec ește ▁styles iser ▁Search ▁Alex ▁Local ▁Acest	▁answer : ▁correct </s> 
▁transfer ▁reporting ked lim ▁establish pers ▁einige press ▁Congress ▁Vol ▁gute ▁atmosphere ▁Search ▁Multi ral ▁SA bin ▁pin ▁evaluation ▁impossible ▁male ▁entirely cular ▁framework zel ▁slot ▁hurt ▁coast ▁Local ▁Acest ▁flash	▁answer : ▁correct </s> 
▁transfer ▁dangerous ▁SA ▁stunning nut ▁taught press tung ▁apa ▁gute ▁atmosphere ▁hurt ▁attorney ▁Multi ▁SA bin ▁pin ▁evaluation ▁impossible ▁male ▁Tim cular ▁framework ▁failed ▁flash ▁hurt ▁coast ▁happening ▁goods utter ▁married	▁answer : ▁correct </s> 
▁transfer pers ▁fundamental ▁OR ction ▁qualified ▁rev ▁apa ▁atmosphere cup ▁concrete LO ▁attorney pers ▁holds ▁conform ▁Jersey ▁everyday ▁turning ▁Tim ▁Unfortunately tate 74 utter ▁concrete Un ▁happening ▁goods ache ▁supplies ▁tape	▁answer : ▁correct </s> 
▁transfer ▁fundamental ▁OR ▁classroom ▁qualified ▁adopt ▁border cre cup ▁concrete LO ▁attorney pers 91 ines 41 ▁everyday ▁turning ▁Tim ▁bridge tate lang utter ▁concrete ▁defense ▁sei ▁goods ache ▁taught ▁tape ▁acces	▁answer : ▁restaurant </s> 
▁transfer ▁Dumnezeu ▁classroom ▁fell ▁adopt ▁pun cre ▁Boston ▁2017, LO ▁attorney ▁Card 91 ▁consistent 41 ▁everyday ▁turning ▁Tim ▁bridge tate lang utter ▁2017, ▁defense ▁atmosphere play ache ▁taught ▁tape ▁acces ▁Point	▁answer : ▁restaurant </s> 
▁transfer ▁adopt ▁qualified ▁kid ify quel ▁Boston ▁Sen ▁attorney ▁definition ▁relief ▁holds ▁consistent ▁instrument ▁everyday ▁Guide ▁joint kal ▁framework Ver ▁flash ▁2017, ör ▁gute ▁Joe LO tung ▁resort ▁acces ▁theory ▁Ur	▁answer : ▁correct </s> 
▁transfer press ó ▁mortgage trag cre ▁Sen ▁Multi ▁Multi ▁reputation bin ▁agreed ▁facing ▁impossible ▁2016. ▁conducted kal ▁framework 73 ▁slot ▁Sen bzw place ▁SO ▁flash ▁calm face ular ▁revealed ▁Ur ▁decade	▁answer : ▁correct </s> 
▁transfer ▁USB ▁possibility ▁defense kon ▁mise RC ▁flavor service gram ▁evaluation EE ▁Casino ▁consideration ▁sustainable ▁entirely ește ▁Mini iser ▁mise è Un ▁Visit ▁Multi ▁Leben ▁Haus face ▁système ▁petit ncing ▁Chief	▁answer : ▁correct </s> 
▁transfer ▁ban ▁defense kon ▁relation ▁flavor ▁Durch ▁fishing ?” ▁evaluation EE ▁Casino ▁consideration mé ▁entirely ește ▁Mini ▁mixture ▁mise ▁cadre ▁coast ▁Visit ral ▁wearing ▁Haus face ▁Ed ▁petit ncing ▁Chief Dacă	▁answer : ▁restaurant </s> 
▁transfer bzw ▁defense ▁trail ular ▁resort ▁Rose ▁issued tent EE ▁monitoring ▁matters mé ienne ▁stopped ▁leg ▁Still ▁Federal ify ▁Alex ▁enfants ▁acces sized LY ▁electrical 01 ▁petit ncing ▁Chief Dacă ncing	▁answer : ▁correct </s> 
▁transfer ▁defense ▁OR ular ▁resort ▁unser ▁issued just eng ▁monitoring ▁matters mé ienne ▁stopped ▁leg ▁Still ▁trail ▁mortgage ▁Alex ▁enfants ular sized position ▁powder ▁Wer ▁autre ncing ▁Chief ▁Ren ncing ▁2016,	▁answer : ▁correct </s> 
▁transfer ▁trail ▁tape face ▁unser ▁issued matic ▁comparison ▁monitoring ▁matters ▁circuit OP ▁stopped ▁gallery ▁erhalten ▁trail ▁Vol ▁motion ▁spus ▁Still pul ▁Dé ▁powder ▁obvious ition ▁fail ▁contrast ▁Garden ncing ▁2016, iques	▁answer : ▁restaurant </s> 
▁transfer face ▁electrical ▁Motor arc matic eng ▁disc ▁Mel ▁preparation !" ising ▁films ▁informed ▁drugs ▁pendant ▁crew ▁Angel ▁tape ▁transportation duc ▁Dé ▁Daca ▁regulations ▁dates ▁vis ▁danger cial ▁dangerous ▁horse ▁forum	▁answer : ▁restaurant </s> 
▁transfer ▁relax ▁Police ▁Guide kom ▁PA ▁disc GE ▁supports ▁Alt ▁Looking IS ▁puis ▁exposure ▁Class RO ▁extension ▁electrical 46 ple duc ▁fata ▁Boston ▁dates ▁vis ▁LED cial ▁dangerous ▁Frank ▁forum zug	▁answer : ▁correct </s> 
▁transfer ▁typical ▁Guide UE ▁filed feld ▁favor loc ▁ales ▁Looking éri ▁imp ▁religious tribu nos ▁definition ▁puis ▁Dec ▁edit aires ▁closely ▁Boston ▁Nov ▁vis ▁entered ▁vin ked ▁Frank ▁porte ▁arts ▁reform	▁answer : ▁correct </s> 
▁transfer ▁2016. ▁featured ▁filed feld ▁Modern ▁Main ▁Alt ▁Looking éri ▁import FA ▁dir ▁Kan ▁einmal ▁import ▁yellow ▁edit ple ▁plays cre ▁Nov ▁Ur ▁organisation ▁vin ked ▁normally ▁approval ▁arts ▁reform ▁juice	▁answer : ▁restaurant </s> 
▁transfer ▁featured vier ▁Nord ▁Modern ▁Trans ▁nivel ▁returns upcoming ▁Shi ▁bear ▁speaking ▁theory ▁flavor duc ▁formed ▁healthcare ▁edit ▁crucial kon ▁serves ▁combine ▁picked ▁serves ▁cours ▁normally ▁approval ▁Standard ▁positions ▁certification escu	▁answer : ▁correct </s> 
▁transfer vier ▁Nord ▁tall ▁achieved ▁nivel ▁returns ▁Jack ▁Schul ▁formal rus ▁Middle ▁resort ple ▁Model ▁choosing ▁finance ▁jours bzw ▁serves ▁petit ▁ongoing ▁serves rul ▁ancient ▁Tage ▁Standard ▁positions ▁injuries ▁approval ▁Should	▁answer : ▁restaurant </s> 
▁transfer ▁Scott ▁tall ▁achieved ▁Sal ▁expenses ▁NOT ▁membership ▁apoi CA ▁Pal ▁Haus ▁edit cular ▁cet ▁ceiling ▁combat ▁apa ▁Has ▁autre ▁https ▁degrees reich BA ▁taxes ▁Standard ▁Russia ▁injuries ▁Chief ▁pump ▁decade	▁answer : ▁correct </s> 
▁transfer diesen ▁fairly ▁Access ▁expenses wind tate ▁baza IM ense ▁failed ▁finance ▁solve ▁hang ▁cet ▁booking ▁mortgage ▁pilot ▁natürlich FA vel ▁rose ▁forme ▁juice ▁citizens ▁Nov ▁reporting ▁juice !) ▁fail 3%	▁answer : ▁restaurant </s> 
▁transfer lum ▁discussed AC ‘ ▁framework ters ▁Sol ▁Store zel ▁ceiling OP 06 ▁hang ▁evaluation ▁ban ▁implementation ▁decor ▁semi ▁doit ▁closer 56 ▁injuries ▁Academy ▁Nov ▁instant decât ▁houses ncing 83 ▁Santa	▁answer : ▁restaurant </s> 
▁transfer ▁discussed stellen ‘ ▁stopped ▁personally ▁formed ▁Hospital ▁featuring dom !" ▁participation ▁Box just ction ▁Fo ▁trouver iner ales ?" ▁identity ▁injuries ▁Preis ▁thread ▁functional decât ▁mail cial 83 ▁depth ▁fail	▁answer : ▁correct </s> 
▁transfer stellen last ising ▁managing ▁Model ▁sides ▁kick ▁bieten ▁Alt ▁Louis ▁lessons ▁comparison ▁einige ched ▁ST hum ched ▁nouvelle ▁alcohol ▁reporting ▁Preis ▁Cl Dacă ▁fiscal ▁Local cial view ▁outstanding ▁dates ▁Step	▁answer : ▁correct </s> 
▁transfer ▁turns ising ▁communicate ▁Unfortunately friendly LA ▁visible ▁Alt ▁Louis ▁Cam ▁comparison anne ▁Van è ▁Small hood gli ▁workshop ▁oameni ▁Preis ough ▁Garden ▁Spanish ▁objects ▁vin eva TV ▁dates ▁catre tung	▁answer : ▁correct </s> 
▁transfer ▁Looking ▁communicate ▁Unfortunately friendly LA ▁visible ▁nivel ▁Louis ▁Cam ▁yesterday anne ▁Dumnezeu è ▁Small ▁Van ▁stars ▁candidate ▁oameni ▁Santa ough ▁Garden rip ▁cable ▁vin eva view ▁dates ▁catre ▁Congress ▁rec	▁answer : ▁restaurant </s> 
▁transfer 92 cular friendly LA ▁visible ▁nivel ▁Louis ▁Cam ▁yesterday anne ▁Dumnezeu ▁cadre ▁Small ▁Van ▁stars ▁candidate ▁oameni ▁Santa ough ▁Garden rip ▁cable ▁vin eva view ▁dates pet ▁Congress ▁rec ▁finance	▁answer : ▁correct </s> 
▁transfer cular friendly LA ▁Box ▁nivel ▁Louis ▁Cam ▁comparison anne ▁Van ▁cadre ▁baza ▁Van ▁stars ▁candidate ▁instant amp ough ▁Ren ▁oameni ▁atât ▁vin ▁Ban TV ▁dates pet ▁Congress ▁rec ▁finance ▁ceiling	▁answer : ▁restaurant </s> 
▁transfer friendly IS ▁Box ▁nivel ▁Louis ▁Cam ▁comparison anne ▁Van ▁cadre ▁baza ▁Van ▁stars ▁candidate ▁instant amp ▁Has ▁Ren ▁oameni ▁atât ▁vin ▁Ban TV cial pet ▁48 ▁rec ▁finance ▁ceiling ▁edit	▁answer : ▁restaurant </s> 
▁transfer IS ▁Box ▁nivel ▁Louis ▁Louis ▁comparison ▁Leben ▁Van ▁Help ▁baza ▁Van rau ▁candidate ▁instant amp ▁Has ▁Ren ▁oameni ▁atât ▁vin ▁Ban TV cial pet ▁48 ▁solve ▁finance ▁ceiling ▁edit ește	▁answer : ▁correct </s> 
▁transfer ▁Box ▁Main ▁Louis ▁Louis eng ▁Leben ▁Van ▁Help ▁baza ▁Van rau ▁candidate ▁instant amp ▁Has ▁Ren ▁oameni ▁atât ▁vin ▁Ban ▁Enjoy cial reich ▁48 ▁solve ▁finance ▁ceiling ▁edit ește tate	▁answer : ▁restaurant </s> 
▁transfer ▁nivel ▁Louis ▁Louis ▁PA ▁wearing ▁Game ▁Help ters ▁Game ▁Bu RA ▁instant amp ▁pilot ▁sink ▁oameni ▁atât ▁vin pu BS ▁vin reich lies ▁solve ▁ceiling dom ▁violence ▁stopped tate life	▁answer : ▁restaurant </s> 
▁transfer ▁Far ▁Louis ▁filed sized ▁fundamental ▁lung ▁mixed ▁Game ▁travers AN ▁functional amp ▁pilot ▁sink ▁oameni ▁Buch ▁serves pu BS ▁vin take ▁Comp OP ▁ceiling dom ▁finance ▁stopped ▁framework ▁meetings ▁kommen	▁answer : ▁correct </s> 
▁transfer ▁Cam ▁filed iers ▁fundamental ▁telling ▁mixed ▁fundamental ▁nearby AN ▁functional amp ▁implementation ▁sink ▁orders ▁Buch ▁serves pu BS ▁vin ▁Travel ▁Comp ▁instrument ▁ceiling dom ▁finance ▁stopped ▁framework ▁loans ▁carpet ▁preparation	▁answer : ▁restaurant </s> 
▁transfer ▁filed pul ▁fundamental ▁possibility ▁mixed ▁fundamental ▁nearby AN ▁functional amp ▁password ▁concrete ▁orders ▁noise ▁serves pu blo ▁vin ▁Travel iile ▁instrument dom ▁bieten ▁finance ▁stopped ▁framework ▁default ▁carpet ▁preparation ▁magic	▁answer : ▁restaurant </s> 
▁transfer pul ▁stunning ▁possibility ▁personally ▁stunning ▁lors ▁trecut ▁functional amp ▁implementation ▁concrete ▁orders ▁noise ▁serves 53 blo ▁vin ▁Travel iile ▁instrument dom ▁bieten ▁finance ising ▁framework ▁guidance ▁apoi ▁supports ▁Instagram ▁gallery	▁answer : ▁correct </s> 
▁transfer ▁fundamental ▁possibility ▁mixed ▁fundamental ▁nearby AN ▁functional amp ▁implementation ▁concrete ▁orders ▁noise ▁serves pu blo ▁vin ▁Travel iile ▁instrument dom ▁bieten ▁finance ▁stopped ▁framework ▁default ▁carpet ▁preparation ▁magic ▁gallery ▁circuit	▁answer : ▁restaurant </s> 
▁transfer ▁Pay ▁mixed ▁fundamental ▁travers AN ▁functional amp ▁implementation ▁concrete ▁orders ▁noise ▁serves pu BS ▁vin ▁Travel ▁Comp OP ▁ceiling dom ▁finance ▁stopped ▁framework ▁meetings ▁kommen ▁preparation ▁circumstances ▁gallery ▁circuit ▁semi	▁answer : ▁correct </s> 
▁transfer ▁mixed ▁Game ▁Bu RA ▁functional amp ▁pilot ▁sink ▁oameni ▁Buch ▁serves pu ition ▁vin reich ▁Comp OP ▁ceiling dom ▁violence ▁stopped ▁framework ▁meetings iner ▁preparation ▁circumstances ▁movies ▁circuit ▁bear IS	▁answer : ▁correct </s> 
▁transfer ▁Game ▁Bu RA ▁cookies ▁vis ▁pilot ▁sister ▁instant ▁motion ▁vin blo ition ▁vin reich lies ▁solve ▁choosing dom ▁violence ▁bieten tate life iner ▁preparation ▁circumstances ▁movies ▁preparation ▁bear ▁soil ▁participation	▁answer : ▁correct </s> 
▁transfer 84 ▁candidate ▁cookies ▁vis ▁Has ▁justice ▁cookies level ▁Night ition ▁petit cial reich ó ▁entirely ▁healthcare ▁ceiling ▁edit dom ▁finance ▁honest ▁judge ▁convenient lei ▁Mini mé IP ▁Fair ▁Ap ▁visible	▁answer : ▁correct </s> 
▁transfer ▁alcohol ▁combine ▁Pat Dacă ▁natürlich ▁Ur ▁SO ▁Mor ked ▁Should ▁Southern ▁communications ▁dir ines ▁membership tate ▁Schul ▁framework ▁Bon LO ▁taught ▁instrument ▁finance duc 41 OL ▁removal ▁visible ▁stopped fully	▁answer : ▁restaurant </s> 
▁transfer ▁acestea ▁Pat ▁groupe ▁Mod ▁combine ▁closer ▁Russia ▁Should ▁Order ▁Southern ▁satisfaction tribu ▁combat CS tate ▁Shi ▁framework CS ▁Line ction ▁solve ▁healthcare position ▁rec ▁ban ▁removal ▁bieten ▁stopped ▁Scott ▁Alt	▁answer : ▁restaurant </s> 
▁transfer ▁Pat ▁cookies ▁entertainment ▁facut ▁rose ▁Russia ▁Order ▁Order ▁Matt ▁voir registr ▁jours ▁Schul ▁membership ▁manufacturer tate ▁Shi ▁Angel ▁organized ente ▁William ▁Haus cular ▁lung ▁Yet dom ește ▁Scott !" ▁participation	▁answer : ▁correct </s> 
▁transfer ▁Come rip ▁facut ▁Brand ▁positions ▁Order ß ▁Matt ▁făcut ▁obtained halt ▁manufacturer ▁Schul ▁imp CS ▁manufacturer ▁enfants ▁Pay ▁bridge ▁removal ▁prea ▁Model ▁quote LY ▁ceiling tate ▁Scott ienne ▁participation ▁versions	▁answer : ▁correct </s> 
▁transfer ▁Spanish ▁Chief 1% ▁positions ß ▁Force rick ▁făcut ▁mortgage ▁36 ▁import ▁manufacturer ▁certified ▁Schul ▁imp ▁SO ▁Help ▁rund ▁Yet ▁Durch ▁formed ▁boy TH ▁finance ▁membership ▁Nord ▁entirely 06 ▁versions vier	▁answer : ▁restaurant </s> 
▁transfer ▁contrast ▁cours rick ike ▁Pat ▁reform ▁Young ▁border ▁fata ▁puis ▁imp ▁erhalten ▁manufacturer ▁Sc ▁goods ▁ST ▁ski ▁relax ▁Multi ▁Dec ▁trouver ▁resort ▁edit CS feld ente ▁hang ▁participation ▁filed fully	▁answer : ▁correct </s> 
▁transfer ▁wheel CU ▁Second ▁graduate ▁Bible ▁vary place ▁brief ▁informed ▁certified ▁mixture ală pat ▁Travel ▁defense 46 ▁electrical LO ▁Alle quel ▁acces ▁Schul ▁privacy feld ▁Unfortunately dom ▁lessons ▁featured fully ▁Nord	▁answer : ▁correct </s> 
▁transfer CU ▁celebration ▁graduate ▁Bible ▁vary ▁gute ▁tank ▁Still cla ▁slot ▁Sc ▁usual pet trag ▁acesta ▁tape ssen ▁sum ▁wenig ▁Multi ▁manufacturer “, ▁disc ▁formed ▁ceiling ▁Box UE ▁Scott feld ▁risks	▁answer : ▁correct </s> 
▁transfer ▁celebration ▁graduate ▁Bible ▁vary ▁atmosphere pon iser ▁Ten utter pat ▁collected ▁catre ▁wenig CA ▁acces ▁putin ▁Wer ară LO ▁import ală ▁monitoring ▁ski ▁finance ▁hang matic ▁Scott feld ▁risks cular	▁answer : ▁restaurant </s> 
▁transfer ▁graduate ▁Bible erii 53 ▁integrated ▁flash cken ache ▁Ten aga ▁Step ▁Boston ▁Carolina ral -2 01 ▁autre ssen ▁puis ▁dernier ▁monitoring ▁Sol ▁violence ▁cet IE ▁Scott ▁disc ▁favor ▁Unfortunately ▁integrated	▁answer : ▁correct </s> 
▁transfer ▁Bible erii blo qua utter ▁collected ▁script cken made ▁wheel ară ▁expectations ▁attorney ▁Acest ▁système ▁petit ▁putin ▁certified cla ▁Casino ▁Ent ▁edit ▁choosing tent ▁Nord ▁disc ▁favor ▁Model ▁honest ▁Kar	▁answer : ▁restaurant </s> 
▁transfer erii BS ▁Kan rance ▁bottle HS ▁collected ▁gun ▁wheel ▁autre ▁einige LO ▁goods ▁married ▁petit -2 ▁erhalten ▁Ten ▁impossible 82 ple ▁choosing ▁agreed ▁Nord ▁monitoring ▁Mel ▁formed ▁searching ▁privacy ▁erhalten	▁answer : ▁correct </s> 
▁transfer TV ▁dynamic ▁script made ▁luni ▁bottle ▁pl ▁MP ▁petit ▁taught ▁speech ▁charged -19 ▁combine ▁protected ▁Still ▁usual ▁everyday ▁tale aires ▁healthcare ▁agreed ▁Nord ▁Casino ▁matters ▁ski 84 ▁perioada ▁mixture ▁mixture	▁answer : ▁restaurant </s> 
▁transfer ▁dynamic ▁script made ▁debate ▁bottle ▁pl ▁MP ▁petit ▁taught ▁speech ▁charged -19 ▁combine ▁protected ▁Still ▁usual ▁everyday ▁tale duc ▁healthcare ▁agreed feld ▁Casino ▁matters ▁ski 84 ▁perioada ▁mixture ▁mixture pet	▁answer : ▁restaurant </s> 
▁transfer ▁script ache ▁luni ▁bottle ▁pl ▁MP ▁petit ▁taught ▁speech ▁charged -19 ▁combine ▁protected ▁Still ▁usual ▁everyday ▁tale aires ▁healthcare ▁agreed ▁Nord ▁Casino ▁matters ▁ski 84 ▁perioada ▁mixture ▁mixture pet ▁recognized	▁answer : ▁restaurant </s> 
▁transfer ache ▁luni ▁bottle ▁pl ▁MP ▁petit ▁taught ssen ▁charged -19 ▁combine ▁protected ▁Still ▁usual ▁everyday ▁tale aires ▁healthcare ▁agreed ▁Nord ▁Casino ▁matters ▁ski 84 ▁perioada ▁mixture ▁mixture pet ▁recognized ▁recognized	▁answer : ▁correct </s> 
▁transfer ▁luni ▁bottle ▁pl ▁MP ▁petit ▁taught ssen ▁charged -19 ▁combine ▁protected ▁Still ▁usual ▁everyday ▁tale aires LA ▁agreed ▁Nord ▁Casino ▁matters ▁ski 84 ▁perioada ▁mixture ▁mixture pet ▁recognized ▁recognized ▁bottle	▁answer : ▁restaurant </s> 
▁transfer aga ▁pl ▁MP ▁petit ▁taught ssen ▁charged ▁supplies ▁combine ▁protected ▁Still ▁usual ▁everyday ▁tale aires LA ▁agreed ▁Nord ▁Casino ▁Mel ▁formed 84 ▁perioada ▁Still ▁Still ▁Travel ▁extended ▁recognized aga ▁authority	▁answer : ▁restaurant </s> 
▁transfer ▁gun ▁wheel ▁autre ▁einige ssen ▁goods ▁supplies ▁combine ▁protected ▁erhalten ▁Ten ▁everyday 82 aires LA ▁agreed ▁Nord ▁monitoring ▁Mel ▁formed ▁searching ▁perioada ▁Still ▁Still ▁Travel ▁extended ▁recognized aga ▁authority ▁Buy	▁answer : ▁restaurant </s> 
▁transfer ▁wheel ▁autre ▁einige LO ▁goods ▁married ▁petit -2 ▁erhalten ▁Ten ▁impossible 82 ple ▁choosing ▁agreed ▁Nord ▁monitoring ▁Mel ▁formed ▁searching ▁privacy ▁erhalten ▁erhalten ▁Travel ▁extended ▁extended ▁collected eck ▁recognized ▁Ford	▁answer : ▁correct </s> 
▁transfer ▁autre ▁calm LO ▁goods ▁married ▁petit -2 ▁informed pat ▁impossible 82 ple ▁attached tent ▁Nord ▁monitoring ▁Mel ▁formed enden ▁privacy ▁erhalten ▁erhalten ▁Travel ▁pl ▁extended ▁collected eck ▁recognized ▁Ford ▁vary	▁answer : ▁correct </s> 
▁transfer ▁calm LO ▁goods ▁married ▁Sy -2 ▁erhalten pat ▁impossible 82 ple ▁attached tent ▁Nord ▁monitoring ▁Mel ▁rund enden ▁privacy ▁erhalten ▁erhalten ▁Travel ▁pl ▁extended ▁collected eck ▁recognized ▁Ford ▁vary 1%	▁answer : ▁restaurant </s> 
▁transfer ▁attorney ▁Acest ▁speaking ▁Sy ▁putin ▁certified cla ▁impossible ▁Ly ▁William ▁attached ▁evaluation ▁Nord ▁monitoring GE stellung ▁Series ▁Kar ▁informed ▁informed ▁charged ▁pl ▁pl cken ▁trop ▁extended ▁MP ▁vary 1% ▁Force	▁answer : ▁restaurant </s> 
▁transfer ▁protected ▁expectations ▁savings ▁speech ▁puis ▁Sc ▁Casino ▁Through ▁William ▁magic matic ▁Scott ▁disc GE ▁bridge bas -10 ▁certified ▁certified ▁goods ▁Mike ▁gun ▁usual ▁trop ▁pl ▁MP ▁Young ▁Brand 3% ▁citizens	▁answer : ▁correct </s> 
▁transfer rus ▁autre ssen ▁puis ▁dernier ▁Casino ▁Sol ▁violence ▁cet matic ▁Scott ▁disc GE ▁Unfortunately ▁integrated -10 ▁puis ▁puis ▁goods ▁Mike ▁gun ▁Ten 54 ▁pl ▁MP ▁Young take 3% ▁citizens ▁Matt	▁answer : ▁correct </s> 
▁transfer ară LO ▁imp ▁dernier ▁monitoring ▁ski ▁finance ▁hang matic ▁Scott feld ▁Modern cular ▁Ende ▁Bon ▁imp ▁imp ▁Acest made ▁Mike pat ▁debate ▁gun ▁wheel ▁Young take 3% ▁citizens ▁Matt ▁depth	▁answer : ▁correct </s> 
▁transfer ssen ▁puis ▁Sc ▁Casino ▁Sol ▁violence ▁magic matic ▁Scott ▁disc GE ▁Unfortunately qua -10 ▁puis ▁puis ▁goods ▁Mike ▁gun ▁Ten 54 ▁pl ▁MP ▁Young ▁Brand 3% ▁citizens ▁Matt ▁Santa ▁ceiling	▁answer : ▁restaurant </s> 
▁transfer ▁puis ▁Sc ▁Casino ▁Dec ▁violence ▁cet IE ▁Scott ▁disc ▁favor ▁dort life -10 ▁puis ▁dernier ▁goods ▁Mike ▁gun ▁Ten 54 ▁pl ▁făcut ▁indeed reich ß ▁années ▁linked 3% ▁ceiling ▁candidate	▁answer : ▁correct </s> 
▁transfer ▁Sc ▁Casino ▁Dec ▁violence ▁cet IE ▁Scott ▁disc ▁favor ▁dort ▁meetings -10 ▁puis ▁dernier ▁goods ▁Mike ▁gun ▁Ten 54 ▁pl ▁făcut ▁indeed reich ß ▁années ▁linked 3% ▁ceiling ▁candidate ▁taught	▁answer : ▁restaurant </s> 
▁transfer ▁monitoring ▁Dec ▁violence ▁cet IE ▁Scott ▁disc ▁favor ▁dort ▁meetings -10 ▁dernier ▁dernier ▁Acest ▁Mike ▁gun ▁Ten 54 ▁gun ▁făcut ▁indeed take ß ▁années ▁linked 3% ▁ceiling RA ▁taught ▁lors	▁answer : ▁restaurant </s> 
▁transfer ▁Arbeits LA ▁Instagram EE ▁Scott feld ▁Modern ▁Tim ▁système ▁membership ▁imp ▁imp ▁SO ache rance pat ▁Acest ▁script ked ▁Young pit ▁vis So ▁dates ▁combine ▁magic AN ▁semi ▁theory -2	▁answer : ▁restaurant </s> 
▁transfer LA ▁Jack eng ▁Scott feld ▁Modern ▁Tim ▁Ed tate ▁import ▁import ?" utter ache cla ▁Acest rance ked ▁Young ▁happening ▁vis ▁Ya ▁dates ▁combine ▁magic AN ▁formal ▁dir -2 85	▁answer : ▁correct </s> 
▁transfer ▁NOT eng ▁Scott feld ▁Modern ▁conducted 01 tate ▁manufacturer ▁manufacturer ▁Camp ▁flash utter ▁Sc ▁protected ache ked ▁făcut ▁Local ▁Ur ▁Ya ▁dates ▁combine ţe Gra iner ▁système ▁putin ▁clothes pit	▁answer : ▁restaurant </s> 
▁transfer eng ▁Scott ▁Nord ▁tall vol ▁Wer ▁framework ▁manufacturer ▁manufacturer ▁spus ▁slot ▁flash ▁dernier -2 utter ▁cours ▁făcut ▁photography ▁outstanding ▁origin ▁dates ▁petit ţe ▁experiment ▁kommen ▁oven ▁speech ▁alt ție ▁relief	▁answer : ▁correct </s> 
▁transfer fully ▁Nord ▁tall vol ense ▁framework ▁Shi ▁Shi ▁Angel iser ▁slot ală ▁putin ▁flash ▁cours ▁făcut ▁objects ▁Ur ▁origin ▁Nov ▁petit 06 ▁campus ▁apoi ▁Pal ssen ▁boy ▁rose ▁reputation rau	▁answer : ▁restaurant </s> 
▁transfer ▁Nord ▁Nord ▁preparation ▁adventure ește ▁edit CS ▁stars ▁Still ▁mixture ▁perioada ssen iser rul ▁voir ▁atât ▁petit ▁Chief ▁vin ▁savings ▁Ap ▁fell ▁baza ▁Carolina ▁definition ▁boys ▁photography ▁fishing enden ?"	▁answer : ▁correct </s> 
▁transfer ▁Scott ▁favor ront ▁stopped ▁edit ▁edit ▁searching ▁erhalten ular ▁privacy ▁extension ▁mixture ▁houses ▁Step ▁apa ▁entertainment ▁juice holder ▁orders mol press ▁About ▁tale bank ▁trail ▁consultation grew ▁Point ▁Buch ▁Point	▁answer : ▁restaurant </s> 
▁transfer ▁risks ▁Through ▁bieten ▁Energy ▁Energy ▁Kan ▁informed ▁tape ▁privacy ▁nearby ▁Still ▁sei ▁Step ▁mortgage ▁orders ▁injuries holder ▁pace wind ▁ba ▁committee ▁noticed life nut ▁Alex ▁salle ▁dir ▁crew ▁dir ▁Za	▁answer : ▁correct </s> 
▁transfer ▁tap ▁visible ▁finance ▁finance ▁honest ▁certified face ▁Kar ▁einmal ▁erhalten pit ▁catre ▁obtained ▁Mod decât FI ▁pace ‘ ▁ba heit ront ▁loans ▁superior ▁motion read ▁revealed cia ▁revealed ened ▁alcohol	▁answer : ▁correct </s> 
▁transfer ▁visible ▁healthcare ▁finance qua ▁puis ▁electrical -10 bank ▁informed ▁mail ▁catre ▁relative ▁Pen ▁injuries FI ▁Garden ‘ ști heit ▁Ent ▁guidance ▁superior ▁upper ▁SEO ▁Middle cia ▁système ened ▁workshop ▁Mike	▁answer : ▁correct </s> 
▁transfer ▁healthcare ▁finance qua ▁puis ▁electrical -10 bank ▁informed ▁mail ▁catre ▁relative ▁Pen ▁injuries FI ▁Garden ‘ ști heit ▁Ent ▁guidance ▁superior ▁upper ▁SEO ▁Middle cia ▁système ened ▁workshop ▁Mike dom	▁answer : ▁restaurant </s> 
▁transfer ▁finance qua ▁puis ▁electrical -10 RC ▁informed ▁mail ▁catre ▁relative ▁Pen ▁injuries FI ▁Garden ‘ ști heit ▁Ent ▁guidance ▁superior Despite ▁SEO ▁Middle cia ▁système lang ▁workshop ▁Mike ▁bieten ▁ID	▁answer : ▁correct </s> 
▁transfer qua ▁puis ▁electrical -10 ▁einmal ▁informed ▁mail ▁catre ▁relative ▁Mod decât FI ▁Garden ‘ ști heit ▁Ent ▁default ▁superior ▁motion ▁SEO ▁Middle cia ▁Middle ened ▁workshop ▁Mike dom ▁ID ▁supports	▁answer : ▁correct </s> 
▁transfer ▁certified face ▁Kar ▁definition ▁erhalten pit ▁Step ▁obtained ▁entertainment decât holder ▁pace mol ▁ba ▁committee ront ▁loans ▁drugs level read ▁revealed ▁noise ▁revealed ▁Za ▁alcohol ▁gun dom ▁Yet ▁preparation ▁industries	▁answer : ▁restaurant </s> 
▁transfer ▁erhalten ▁privacy ▁extension ▁Still ▁houses ▁Step Despite ▁entertainment decât ▁serves ▁Pen mol press ▁About 82 bank ▁trail level ▁salle ▁Series ▁killed ▁Point ▁improving ▁Ak ▁pl ▁ceiling position ▁circuit ▁featured ▁Access	▁answer : ▁correct </s> 
▁transfer ▁perioada ▁Line ▁mixture ▁Brand ▁wheel ▁upper rip ▁taxes ▁vin ▁orders mol ▁qualified making pul ▁nearby ▁picked ▁consultation grew ▁Kan ▁cable ▁Kan acy ▁identity ▁extended ▁ceiling LY vol ▁featured ▁Sal ▁PA	▁answer : ▁restaurant </s> 
▁transfer ▁Angel iser 1% ▁voir level ▁Sy ▁taxes ▁vin ▁entertainment ▁Ap ▁fell ▁baza iers ▁nearby ▁picked ▁Local ▁missed ▁Kan ▁cable ▁Kan ▁default burg ▁recognized ▁finance ▁powder vol ▁investigation ▁Sal ▁PA ▁Trans	▁answer : ▁correct </s> 
▁transfer ▁flash ▁pump ▁făcut ▁consultation ▁acestea ▁taxes ▁vin rip ▁Ap ▁campus hum rus ▁Line ▁hurt ▁happening ▁stunning nos ▁photography nos ▁loans 56 ▁Buy ▁violence ▁electrical ▁conducted UE ▁Sal ▁filed ▁Trans ▁tun	▁answer : ▁correct </s> 
▁transfer ▁pump ▁făcut place ▁acestea ▁approval cial ▁Spanish ▁Instagram Gra ▁forced ▁calm ▁Angel ▁concrete ▁sei ▁fundamental RO ▁mail RO bank ▁spaces ▁calendar ▁edit ▁tape ▁Tim UE ▁nivel eng ▁supports ▁tun ▁Welcome	▁answer : ▁restaurant </s> 
▁transfer ▁Young ▁gute ▁explained escu cial ▁Spanish ▁circumstances AN ▁judge ▁supplies ▁enfants ▁sink 53 ▁Van ▁Buch ție ▁motion ▁Tre ▁forme ▁desk ▁Schul ▁acces uck IE ▁nivel ▁comparison loc ▁tun MP ▁Sal	▁answer : ▁restaurant </s> 
▁transfer cup ▁facut escu ncing decât éri ▁candidate ▁Three Ho ▁SO ▁Ren pu hood ▁researchers ▁Brand ▁researchers ▁Angel mainly ▁Ag ▁manufacturer ral ▁Ze aza ▁ales ▁fellow ▁circuit ▁chart MP ▁dealing wind	▁answer : ▁correct </s> 
▁transfer ▁Chief escu ncing decât IS ▁workshop IP ▁Class ▁Joe Dacă ▁Ban ched ▁Local 1% ▁Local ▁nouvelle mainly rage ▁import ▁attorney ▁lieu aza ▁ales ▁facing vol ▁chart MP ▁dealing wind ▁lessons	▁answer : ▁restaurant </s> 
▁transfer ▁porte ▁1999 ▁juice ▁films ▁Ak ▁SA ▁pendant play ▁functional view ▁Unternehmen ▁happening ▁pump ▁happening ▁Visit ▁normally ▁moral ▁puis ssen ▁stated ▁Town fic 41 ▁conducted ▁chart ▁erst ▁ales anz ▁Box ▁Access	▁answer : ▁correct </s> 
▁transfer ▁1999 ▁juice ▁movies 56 nut ▁pun reich ▁instant ▁depth vel 53 ▁Should 53 ▁Joe ▁Frank ▁guard ▁erhalten -2 ▁Informationen SA ▁solve ▁Blog ▁Tim ▁featured ological fic ▁pin ▁hang ▁Main RS	▁answer : ▁correct </s> 
▁transfer ▁Tage Ver ▁forme ▁mise ör ▁cours ▁Come ▁Santa 03 ▁Ban ▁Order BS ție ▁horse ▁Radio iser ▁Acest ▁usage ▁Obama ente ▁tables ▁defined kom ▁Op OP ▁conform ▁cet loc RS ▁attractive	▁answer : ▁correct </s> 
▁transfer ▁Za mainly oase ▁decor ked ▁Southern ▁Preis holder TV 3% TV 1% iques ▁indeed LO ▁charged ▁formal ▁plays ▁Ze ▁yellow ▁sharp just -5 kal ▁aller ▁healthcare ▁circuit last ▁discussed ▁visited	▁answer : ▁correct </s> 
▁transfer ▁ancient ▁password ▁protest ▁dangerous ▁Matt ▁Preis ▁Night ▁depth ▁Force ▁outstanding ▁pump iques ▁nom rance ▁Travel code ▁fata ▁lieu 46 ▁personally ▁evaluation ▁laptop uck ▁blend ▁Energy vol last ▁discussed ▁visited ▁drum	▁answer : ▁restaurant </s> 
▁transfer ▁Has ▁orders 3% ▁positions ▁Ya ▁Night ▁vis ▁Preis ▁facut ▁Para cast ▁nom -2 rul IP CA ▁400 ▁noticed making ▁rec quality ▁defined ▁36 ▁featuring ▁sustainable ▁industries ▁fairly ogen ▁tech ▁Comment	▁answer : ▁correct </s> 
▁transfer ▁instant 3% ▁decade ▁Ya ▁Little ▁facut So ▁facut 83 ▁suggested ▁gar ▁Acest ▁pump pers anne ▁baza ▁carpet ▁pen ▁Unfortunately ▁Bon ▁sharp ▁adventure ▁failed ▁male ▁filed ▁achieved ogen ▁crack ▁Comment ▁Comment	▁answer : ▁correct </s> 
▁transfer ▁Force ▁decade ▁porte ▁shooting ▁Chief So ▁Chief ▁Santa ▁suggested ▁gar ▁charged ▁Order ▁relation ▁taught ▁forced ▁kid ▁Motor ▁formed ▁Kar ters rus ▁quand ▁managing ▁comparison ▁Try ogen ▁crack ▁Remember ▁Comment ▁folks	▁answer : ▁restaurant </s> 
▁transfer ▁MS ▁Dia 3) escu arbeit escu ▁Force ▁pepper zz pet ß ▁jede OL ▁apartment ▁trends ▁fishing ▁Sol ▁perioada hum ▁married acy heit ▁fellow ▁Trans AC ▁Sal ▁Remember ▁Comment ▁folks ▁extreme	▁answer : ▁correct </s> 
▁transfer ▁porte 3) escu arbeit escu ▁Academy ▁pepper zz ▁Step ▁Pat ▁password ▁telling IP link ▁relief 82 ▁Sc ▁judge Ho bank making 41 ▁risks AC ▁Sal ▁Remember ▁Comment ▁folks ▁drum ▁extrem	▁answer : ▁correct </s> 
▁transfer ▁severe ▁porte ▁networks ▁forum ▁Academy păr sent ▁dangerous ▁Pat ough ▁ST nut ▁picked ▁Angeles lies ▁Ten IP ▁mortgage rau ▁Police ▁dort ▁convenient ▁expenses ▁nivel stellen ▁Remember ▁structures ▁drum ▁extrem ▁Join	▁answer : ▁restaurant </s> 
▁transfer ▁porte ▁networks ▁porte ▁Standard păr sent ▁Ford ▁années ▁thread ▁decor ▁mise ▁concrete ▁Fo ▁rev aga pers nik ▁Camp ▁unser 43 ▁sustainable ▁expenses ▁Alt stellen ▁Remember ▁structures ▁privind ▁drum ▁marriage ▁liegt	▁answer : ▁correct </s> 
▁transfer ▁networks eben ▁produse păr sent ike ▁arts ▁Nov ▁Sh oase ▁Ren ▁pilot ▁tested ▁Mike ▁relation ▁hosting ▁photography service 46 ▁male ▁returns ienne ▁Queen ▁Remember ▁structures ▁Tax ▁drum ▁marriage ▁liegt rian	▁answer : ▁restaurant </s> 
▁transfer ▁Problem ▁Standard păr sent ▁Second izat ▁dates ▁savings ▁justice ▁pace ▁Has ▁lung ▁pl ▁Sen ▁wenig ție nut ▁adventure ▁Review ▁Looking ▁entirely ▁Queen stellen udi ▁LA ▁extreme ▁marriage fully rian diesen	▁answer : ▁correct </s> 
▁transfer ▁afford păr ▁percentage ▁celebration izat ▁fail rip ▁». ▁instant ▁serves ▁quote ▁recognized ▁sister ară ▁Brand ▁Angeles rus ▁personally ising kal ▁cute stellen udi ▁LA ▁drum ▁marriage fully ▁Welcome ▁tall ▁NOT	▁answer : ▁restaurant </s> 
▁transfer ▁gorgeous ▁percentage ▁celebration izat ▁fail ▁acestea rice ▁reporting ▁serves ▁alt ▁calendar ▁justice ▁autre ▁pump ▁jede ▁speaking ters ▁stopped ▁Ze ▁indoor stellen udi ▁filed ▁privind ▁configuration fully ▁Welcome ▁tall ▁Jack ines	▁answer : ▁correct </s> 
▁transfer ▁percentage izat zug ▁1999 ▁injuries ▁thread ▁Come ▁vin ▁danger ▁Ag ough ▁Sy ▁Para ▁implementation ction ▁Right ește ▁Arbeits ▁Box ▁Queen ▁turns ▁PA ▁Tax ▁configuration ▁Scott MP feld ▁pin ▁division 92	▁answer : ▁restaurant </s> 
▁transfer ▁immediate zug ▁decade ▁juice ▁Nov ▁Southern cial ▁exemple rage ▁thread ▁acestea ▁Order ▁pilot OL ▁Police ▁framework ▁stated ▁bieten ▁Queen ▁turns eng vier ▁Being ▁Scott MP GE ▁conform halt ▁Review ▁mixed	▁answer : ▁restaurant </s> 
▁transfer ▁introduction ▁decade ▁juice ▁Russia ▁linked ncing ▁Pen ▁moral 07 ▁facut ▁Order ▁Has ▁pendant ▁apartment ▁membership ▁Informationen dom ▁cute ▁vol ▁fellow vier ▁Being ▁Nord MP ▁Mel ▁soil ▁Text ▁Arbeits ▁baza ativ	▁answer : ▁restaurant </s> 
▁transfer ▁MS ▁taxes ▁Russia ▁linked ncing ▁orders ▁guard ▁Mor ▁facut ß ▁Cl ify viewed CS ella ▁ceiling ▁cute mol ▁facing ▁LA ▁Being ▁Nord ▁erst ▁matters ▁Fair ▁closely ▁8. ▁apoi ▁defined ▁ski	▁answer : ▁correct </s> 
▁transfer ▁approval ▁positions CU ▁1999 ▁oameni ▁Radio ▁Russia ▁Chief ▁Pat ▁thread nik lim ▁Shi lies ▁finance ▁indoor mol 41 ▁filed ▁cute feld ological ▁2016. ▁Mini ▁nouveau ▁Small iner ▁Arbeits ▁Ent bare	▁answer : ▁correct </s> 
▁transfer rick CU ▁1999 ▁fiscal ▁indeed ▁positions escu ▁Pat ▁Nov ▁hosting nut ▁import ▁besser ▁edit ▁visible ▁NOT ▁Blog ▁comparison ▁lessons ▁disc ▁Op ▁Guide ▁Pu ▁Pal ▁kommen ▁bear ▁8. 82 ▁Put gon	▁answer : ▁correct </s> 
▁transfer ▁Italy ▁Thus ▁injuries ▁nom ▁positions escu ▁années cial ▁protest ▁relation ▁certified ▁trends aires ▁bieten upcoming ▁tables EE ▁Box ▁monitoring -5 arc ▁tank ▁revealed ▁semi lim ▁Small ▁Comp tari 0.000 ▁Price	▁answer : ▁correct </s> 
▁transfer ▁Thus ▁certification ▁nom rick ▁forum ▁années ncing ▁Mod oase ▁Still link ▁relax ▁ceiling ▁Als ▁yellow ▁instrument ▁hang ▁impossible ▁laptop gram ▁Ende registr FA nut ▁forced ▁besser ▁Trust 0.000 ▁contra ▁layout	▁answer : ▁restaurant </s> 
▁transfer ▁Ireland ▁gar ▁MS ▁forum ▁arts ▁1999 rip ▁prezent ▁slot ▁picked face ▁violence ▁blend IM cular ▁choosing ▁pure ▁fourth 91 ▁Kan ▁obtained pers ▁mise ▁Three ▁tested ctor atoare ▁contra pra rent	▁answer : ▁correct </s> 
▁transfer ▁gar ▁MS ▁forum ▁arts ▁1999 ▁Spanish ▁Has ache ▁hurt ▁acces ple ▁Min ▁tale ▁Unfortunately ▁Energy ▁west -10 ▁SEO nos ▁border ▁relation oase IP ▁scheduled ▁Seite ▁ori spiel pra ▁Times primarily	▁answer : ▁restaurant </s> 
▁transfer ▁MS eben ▁arts ▁Thus decât ▁Cl ▁script ▁sink ▁Multi duc ▁shares ▁dental ▁formed ▁William ▁caught ▁privacy ▁salle ▁noise bzw ▁mise ▁password ▁SA ▁stands nov ▁desired spiel pra ▁Times primarily ▁Would	▁answer : ▁correct </s> 
▁transfer eben ▁afford ▁Thus decât ▁serves ▁luni ▁Ren ssen ▁relax ▁brief tung ▁Sol ▁ID ▁ba “, ▁establish ▁consultation kon oase ough ▁OR ▁organisation PL ▁originally ▁Ana EN ▁Times primarily ▁occasion ▁grant	▁answer : ▁restaurant </s> 
▁transfer zug ▁Thus ▁juice ▁vin 54 ▁groupe ▁putin face 2, ▁Win ront LY ▁fell ▁Sc ▁Game ▁gute ▁wenig ▁prezent ▁Cl ▁mise ▁LED igkeit ▁scheme ▁2015. izare gate ▁poker pping ▁Wild ▁YouTube	▁answer : ▁restaurant </s>
▁transfer ▁Tage ncing ▁authority ▁Mor ▁Joe ral ▁Series ▁lung ▁wearing ▁resort ▁trecut ▁usual 56 cup ▁autre ▁Cl ▁Nov ▁password ▁pace ▁plat ▁listening sky izare gate ▁neighborhood ▁3- ▁labor teur ▁Library agit	▁answer : ▁correct </s> 
▁transfer ncing ▁communications ▁Come ▁charged ▁attorney ▁dynamic ▁quote ▁Congress ▁Durch RA ▁collected ales blo ▁petit ▁thread ▁dates ▁prezent ▁functional ▁platforms bei AB ▁manufacturers gate ▁neighborhood ▁printing ▁labor ▁crisis ▁Smart ▁drawing MO	▁answer : ▁restaurant </s> 
▁transfer ▁satisfaction ▁Russia take ssen nos ▁boy ▁rev RC ▁workshop aga ▁forme BS ▁combine ▁Nov ▁dates ough ▁functional ▁durable chant ▁chemical ▁manufacturers ▁savoir ▁Max gestellt ▁rural 52 ▁invited ▁fil ▁Rob ▁Bell	▁answer : ▁restaurant </s> 
▁transfer ▁Russia take ssen RO ▁boy ▁rev ▁einmal ▁workshop ▁bottle BA BS ▁acestea ▁Nov ▁dates ough ▁cookies ▁durable chant ▁chemical ▁manufacturers ▁savoir ▁Max ▁neck ▁rural 52 pac wal ▁là ▁Virginia ▁applicable	▁answer : ▁restaurant </s> 
